----------------------------------------------------------------------------------------------------------------------------------------------------------------
-------------------X-----------------------------XX------------------------X--------X-----------------------------------------------X-------------X-------X-----
---X---X-----------X----X-----------X-X----------XX------------X-----------X--------X---------------------X---------------X-------X-X----X--------X-X-----X-----
---X---X----XX-----X----X---X---X---X-X----------XX------------X-----------X--------X---X----------X------X---------------X-------X-X----X--------X-X---X-X-----
---X---X---XXX-----X----X---X---X---XXX----------XX----X-------X------X----X---XX---X---X----X-----X------X---------X----XX-------X-X----XX---X---X-X--XX-X-----
---X---X--XXXX-----X--X-X---X---XXX-XXX-------X-XXX----X-----X-X------X----X---XX---X---X----X-X---X------X----X--X-X----XX-----X-X-X----XX---X---X-X--XX-XX-X--
--XX---X--XXXX-----X--X-X--XX---XXXXXXX-------X-XXX----X-----X-XX-----X----X---XX-X-X--XX----X-X---X---X--X----X--X-X----XX-----X-X-X---XXX---X---X-X--XX-XX-X--
--XX---XXXXXXX-----X--X-X--XX--XXXXXXXX-X-X-X-X-XXX----X-----X-XX-----X---XX--XXX-X-X--XX--X-X-X---X---X--X----X--X-X----XX---X-XXX-X---XXX---X---X-X--XX-XX-X--
--XX---XXXXXXX-----X--X-X--XX--XXXXXXXX-X-X-X-X-XXX----XX----X-XX--X--X--XXXX-XXX-X-X-XXX--X-X-X--XX---X--X----XX-X-X----XX---X-XXX-X-X-XXXX--X-X-X-X--XX-XX-X--
--XX-X-XXXXXXX-----X--XXX--XX-XXXXXXXXX-X-X-X-X-XXX-X--XXX---X-XX--XX-X--XXXX-XXX-X-X-XXX--X-XXX--XX---X--X----XX-X-XX---XX--XX-XXX-X-X-XXXX--X-X-X-XX-XX-XX-X--
--XX-X-XXXXXXX-----X--XXX--XXXXXXXXXXXX-X-X-X-X-XXX-X--XXX---X-XX--XX-X--XXXX-XXX-X-XXXXX--X-XXX--XX---X--X---XXX-X-XX---XX--XX-XXX-XXX-XXXX-XX-X-X-XXXXX-XX-X--
--XX-X-XXXXXXX-----X--XXX--XXXXXXXXXXXX-X-X-X-X-XXXXX--XXXX--X-XX-XXX-XXXXXXX-XXX-X-XXXXX-XX-XXX--XX--XX--X-X-XXX-X-XXX--XX--XXXXXX-XXX-XXXX-XX-XXX-XXXXX-XX-X--
--XX-X-XXXXXXX-----X--XXX--XXXXXXXXXXXX-X-X-X-X-XXXXX--XXXX-XX-XX-XXX-XXXXXXX-XXXXXXXXXXX-XX-XXX--XX--XXX-X-X-XXX-X-XXX--XX--XXXXXX-XXX-XXXX-XX-XXX-XXXXX-XXXX--
M-XX-X-XXXXXXX----XX--XXX--XXXXXXXXXXXXXX-X-X-X-XXXXX--XXXX-XX-XX-XXX-XXXXXXX-XXXXXXXXXXX-XX-XXXX-XX-XXXXXXXX-XXX-XXXXX-XXX--XXXXXX-XXXXXXXX-XX-XXX-XXXXX-XXXX-F
X-XXXX-XXXXXXX----XX--XXX-XXXXXXXXXXXXXXXXX-X-X-XXXXXXXXXXXXXX-XX-XXX-XXXXXXXXXXXXXXXXXXXXXX-XXXX-XX-XXXXXXXXXXXXXXXXXX-XXXXXXXXXXXXXXXXXXXX-XX-XXX-XXXXX-XXXX-X
X-XXXX-XXXXXXXXX-XXXX-XXX-XXXXXXXXXXXXXXXXXXXXXXXXXXXXXXXXXXXX-XX-XXXXXXXXXXXXXXXXXXXXXXXXXX-XXXX-XX-XXXXXXXXXXXXXXXXXXXXXXXXXXXXXXXXXXXXXXXXXX-XXX-XXXXXXXXXX-X
