----------------------------------------------------------------------------------------------------------------------------------------------------------------
-------------X------X------X-----------------------------------------------------------------------------------X---------X--------------------------------------
--------X----X------X------X---X---X--------------------X---X------------------X-----------------X-------X-----X-X--X---XXX-------------------------X-----------
-X------X-X--X---X--X------X---X---X--------------------X---X------------X-----X-X-------------X-X-------X-----X-X--X-X-XXX------X--X-------X-------X-----------
-X------X-X--X---X--X------X--XX---X---------XX----X----X---XX----------XX-----X-X-X-----------X-X-------X-----X-X--X-X-XXX------X--X-------X-------X-----------
-X----X-X-X--X---X--X------X--XX---X---------XX----X----X---XX----------XX-----X-X-X-----------X-X---X---X-----X-X--X-X-XXX------XX-X-------X------XX---------X-
-X----X-X-X-XX---X--X------X--XX---X------X--XX----X----X---XX---X------XX----XX-X-X-X--------XX-X---XX--X-----X-X--X-X-XXX------XX-X--X----X------XX-----X---X-
-X----X-X-X-XX---X--XX----XXX-XX--XX------X--XX----X----X---XXX--X--X---XX----XX-X-X-X--------XX-X---XXX-X-----X-X--X-XXXXX------XXXX--X---XX-X----XX--X-XX---X-
-X----X-XXX-XX---X--XXXX--XXX-XX--XX------X-XXX-X--X----X---XXX--X--X---XX----XX-X-X-X----X--XXXXX---XXX-X-----X-XX-X-XXXXX------XXXX--X---XX-X----XX--X-XX---X-
-X----X-XXX-XX-X-X--XXXX--XXX-XX--XX--X---X-XXXXX-XX-X--X---XXX--X-XXX--XX----XX-X-X-X----X--XXXXX---XXX-X-----X-XX-X-XXXXX--X-X-XXXX-XX---XX-X-XX-XX--X-XX---X-
-X----X-XXX-XX-X-X--XXXX--XXX-XX--XX--X---X-XXXXX-XX-X--X---XXX--X-XXXX-XX----XX-X-X-XX---X--XXXXX-XXXXX-X---X-X-XX-X-XXXXX--X-X-XXXX-XXXX-XXXX-XX-XX-XX-XX---X-
-X---XX-XXX-XX-X-XX-XXXX--XXX-XX--XXX-X---X-XXXXX-XX-XX-X---XXXX-X-XXXX-XX---XXX-X-X-XX---X--XXXXX-XXXXX-X---X-XXXX-X-XXXXX--XXX-XXXX-XXXX-XXXX-XX-XX-XX-XX---X-
-X---XXXXXX-XXXX-XX-XXXX--XXX-XX--XXX-XX--X-XXXXX-XX-XXXX---XXXX-X-XXXX-XX---XXX-X-X-XX---X-XXXXXX-XXXXX-X--XX-XXXX-X-XXXXX--XXXXXXXX-XXXX-XXXX-XX-XX-XX-XX---X-
MX--XXXXXXX-XXXX-XX-XXXX--XXX-XXX-XXXXXXX-X-XXXXX-XX-XXXX-XXXXXX-XXXXXXXXXX--XXX-XXX-XXX--X-XXXXXX-XXXXX-X-XXXXXXXXXX-XXXXX--XXXXXXXXXXXXXXXXXX-XX-XX-XX-XX--XXF
XX--XXXXXXX-XXXXXXX-XXXXX-XXXXXXX-XXXXXXX-X-XXXXX-XX-XXXX-XXXXXX-XXXXXXXXXX-XXXX-XXXXXXXX-XXXXXXXXXXXXXX-X-XXXXXXXXXX-XXXXX--XXXXXXXXXXXXXXXXXX-XX-XX-XXXXX--XXX
XXXXXXXXXXX-XXXXXXX-XXXXX-XXXXXXX-XXXXXXX-X-XXXXX-XXXXXXXXXXXXXX-XXXXXXXXXX-XXXX-XXXXXXXX-XXXXXXXXXXXXXX-X-XXXXXXXXXX-XXXXX--XXXXXXXXXXXXXXXXXX-XX-XXXXXXXX--XXX
