----------------------------------------------------------------------------------------------------------------------------------------------------------------
------------------------------X--X------X-------------X-XX----------X------X---X-----------------X--------------------------------------------------XX--X-------
------------------------X-----X--X------X--X----------X-XX----------X------X---X-----------------X------------X--------------XX--------------X------XX--X-------
------------------------X-----X-XXX-----X--X-X--------X-XX-------X--X------X---X--X-------------XX---X-----X--X-----------X--XX--------------X------XX--X-X-X---
-X---X-------XX--X------X-X-X-X-XXXX----X--X-X-----X--X-XX---X---X--X------X---X--X-X---------X-XX---X-----X--X-----------X--XX------X-------X------XX--X-X-X---
-X---X----X--XX--X-X----X-X-XXX-XXXXX---X--X-X---X-X--X-XX---X---X--X------X---X--X-X---X-X---X-XX---X-----X--X-----------X--XX------X-------X------XX--X-X-X---
-X---X----X--XX--X-X----X-X-XXX-XXXXX---X--X-X---X-X-XX-XX--XX-X-X--X---X--X---X--X-X---X-X---X-XX---X-----X--X-----------X--XX--X---X-X-----X------XX--X-X-X---
-X---X----X--XX--X-X----X-X-XXX-XXXXX---X--X-X---X-X-XX-XXX-XXXX-X--X---X--X---XXXX-X---X-X---X-XX---X-----X--X------X----X--XX--X-X-XXX----XX------XX-XX-X-X---
-X---X-XX-XX-XX--X-X-X--X-X-XXX-XXXXX---X--X-X---X-X-XX-XXX-XXXX-X--X---X-XX---XXXX-XX--X-XX-XX-XX---X-----X--XX-X---XX---X--XX--X-X-XXXX-X-XX------XX-XX-X-X---
-X---X-XX-XX-XX-XX-X-X--X-X-XXX-XXXXX---X--X-X---X-X-XX-XXX-XXXX-X--X---X-XX---XXXX-XX--X-XX-XX-XX--XX-----XX-XX-X---XX---X--XX--X-X-XXXX-X-XX---X-XXX-XX-X-X---
-X---X-XX-XX-XX-XX-X-X--X-X-XXXXXXXXX--XXX-X-X---X-X-XX-XXX-XXXXXXXXX---X-XX---XXXX-XX--X-XX-XX-XX-XXX-----XX-XX-X---XX---X--XX--X-X-XXXX-XXXX---X-XXX-XX-X-X---
-XX-XXXXX-XXXXX-XX-X-X--X-X-XXXXXXXXX-XXXX-X-XX--X-X-XX-XXX-XXXXXXXXX---X-XXX-XXXXX-XX--X-XX-XX-XX-XXX-XX--XX-XX-X---XX-X-X-XXX--X-X-XXXX-XXXX---XXXXX-XX-X-X---
-XX-XXXXXXXXXXX-XX-X-XXXX-XXXXXXXXXXXXXXXX-X-XX-XX-X-XX-XXX-XXXXXXXXX---XXXXX-XXXXX-XX-XXXXX-XX-XX-XXX-XXX-XX-XX-X---XX-X-X-XXX--X-X-XXXX-XXXX--XXXXXXXXX-X-X---
MXXXXXXXXXXXXXXXXX-XXXXXXXXXXXXXXXXXXXXXXXXX-XX-XX-XXXX-XXX-XXXXXXXXXX--XXXXX-XXXXX-XXXXXXXX-XX-XX-XXX-XXX-XX-XX-X---XXXX-X-XXX-XX-X-XXXX-XXXX--XXXXXXXXX-X-X--F
XXXXXXXXXXXXXXXXXX-XXXXXXXXXXXXXXXXXXXXXXXXX-XX-XXXXXXX-XXXXXXXXXXXXXXX-XXXXX-XXXXXXXXXXXXXXXXX-XX-XXX-XXX-XX-XX-X--XXXXXXX-XXX-XX-X-XXXX-XXXX--XXXXXXXXXXX-XX-X
XXXXXXXXXXXXXXXXXX-XXXXXXXXXXXXXXXXXXXXXXXXXXXXXXXXXXXXXXXXXXXXXXXXXXXX-XXXXX-XXXXXXXXXXXXXXXXX-XXXXXX-XXX-XX-XX-XXXXXXXXXXXXXX-XXXX-XXXXXXXXXX-XXXXXXXXXXXXXX-X
