----------------------------------------------------------------------------------------------------------------------------------------------------------------
----------X---------X------------------------------------------------------------------X-------------XX------------------X-------------------X---------X-----XX-
----------X---------X--------X---------X---------XXX-------------------X--X------------XX------X-----XX----X----------X--X---X----X------X--XX---------X-----XX-
-------X--X----X---XX--------X--X------X-XX------XXX-------------------X--X---X--------XX------X-----XX---XXX-------X-X--XX--X----X------X--XX---------X-----XX-
-------X--X----X---XX--------X--X------X-XX------XXXX----------X---X---X--X---X-X------XX----X-X-----XX---XXX------XX-X--XX-XX--X-X------X--XX---------X--X--XX-
------XX--X----X--XXX-----X--X--X-----XX-XX------XXXX--X-------X---X---X--X---X-X------XX----X-X--X--XX---XXX------XX-X--XX-XX--X-X---X--X--XX---------X--X--XX-
-----XXX--X-X--XX-XXX-----X--X-XX--X--XX-XX------XXXX--X-------X--XX---X--XX--X-X-----XXX--X-X-X--X--XX---XXX----X-XX-X--XX-XX--X-X---X--X-XXX---------X--X--XX-
-----XXX--XXX--XX-XXX----XX--X-XX--X--XXXXX------XXXX--X---X---X--XX---X--XX--X-X-----XXX--X-X-X--X--XX-X-XXX----X-XX-X--XX-XX--X-X---X--X-XXX---------X--X--XX-
-----XXX--XXX--XX-XXX-X--XX--X-XX--X--XXXXX---X--XXXX--X---X---X--XXX--X-XXX--X-X--X--XXXX-X-X-X--X--XX-X-XXX----X-XX-X--XX-XX--X-X---X--X-XXX---------X--X--XX-
-----XXX--XXX--XXXXXX-X--XX--X-XXX-X--XXXXX-X-X--XXXX--X---X---X--XXX--X-XXX--X-X--X--XXXXXX-X-X--X--XX-X-XXX---XX-XX-X--XX-XXX-X-X---X--X-XXX-X----X--X--XX-XX-
-----XXX--XXX--XXXXXXXX--XX--X-XXXXX--XXXXXXX-X--XXXX-XX---X---X--XXX-XXXXXXX-X-X--X--XXXXXX-X-X-XXX-XX-X-XXX---XX-XX-X--XX-XXX-X-X---X--XXXXX-X--X-XX-X--XX-XX-
---X-XXX--XXX--XXXXXXXX--XX--X-XXXXX--XXXXXXX-XX-XXXX-XXX--X---X--XXX-XXXXXXX-X-X--X--XXXXXX-X-X-XXX-XX-X-XXX---XX-XXXXXXXX-XXX-X-XX--X--XXXXX-X--X-XXXX--XX-XX-
-X-X-XXX--XXX--XXXXXXXX--XX--XXXXXXXXXXXXXXXX-XX-XXXXXXXX-XX---X--XXX-XXXXXXX-XXX--XX-XXXXXX-X-XXXXX-XX-XXXXX---XX-XXXXXXXX-XXX-X-XX-XXX-XXXXX-XX-X-XXXX--XX-XX-
MX-X-XXX--XXX-XXXXXXXXX-XXXX-XXXXXXXXXXXXXXXX-XXXXXXXXXXX-XX---XX-XXXXXXXXXXX-XXX--XX-XXXXXX-X-XXXXX-XXXXXXXXX--XX-XXXXXXXXXXXXXXXXX-XXX-XXXXX-XX-X-XXXX--XX-XXF
XX-X-XXXX-XXXXXXXXXXXXX-XXXXXXXXXXXXXXXXXXXXX-XXXXXXXXXXX-XX---XX-XXXXXXXXXXXXXXX--XXXXXXXXX-X-XXXXX-XXXXXXXXX--XXXXXXXXXXXXXXXXXXXX-XXXXXXXXXXXX-XXXXXX--XX-XXX
XXXX-XXXX-XXXXXXXXXXXXX-XXXXXXXXXXXXXXXXXXXXXXXXXXXXXXXXXXXX-X-XX-XXXXXXXXXXXXXXXXXXXXXXXXXXXX-XXXXXXXXXXXXXXXX-XXXXXXXXXXXXXXXXXXXXXXXXXXXXXXXXX-XXXXXXXXXX-XXX
