----------------------------------------------------------------------------------------------------------------------------------------------------------------
----X----------X------------------------------X------------------------X------------------X-----------------X--------------------------------X-X--------------X-
----X----------X-------X-------------X--------X-----------X------------X---X-------------XX---X--X----------X-------------XX-------------X---X-X--X---X-------X-
----X---X------XX------X-------------XX----X--X-----------XX-----X-----X---X------X------XXX--X--X----X-----X-------------XX--X-------X-XX---X-X--X---XX--X---X-
----X--XX------XX------XX-X----------XXX---X--X-----------XXX-X--X-----X---X---X-XXX-----XXX--X--X----X-----X---X---------XX--X-------X-XX---X-X--X-X-XX--X---X-
----X--XXXX----XX------XX-X----------XXX---X--X-----------XXX-X--X-----X---X---X-XXX-----XXX--X--X----X--XX-X---X------X--XX--X--X----X-XX---X-X--X-X-XX--X-X-X-
----X--XXXX-X--XXX-----XX-X----X-----XXX---X--X-----------XXX-X--X-XX--XX--X---X-XXX---X-XXX--X--X----X-XXX-X---X------X--XX--X--X----X-XX---X-X--X-X-XX--X-X-X-
----XX-XXXX-X--XXX--X-XXXXX---XX-----XXX---X-XX-----------XXX-X--X-XX--XX--X---X-XXX---X-XXXX-X--X----X-XXX-X---X-----XX--XX--X--X----X-XX---X-X-XX-X-XX--X-X-X-
----XX-XXXX-X--XXX--X-XXXXX---XX-X---XXXX--X-XX-----X--X--XXX-X--X-XX--XX--X-X-X-XXX---XXXXXX-X--X----X-XXX-X---X-----XX--XX--X--X----X-XX---X-X-XX-X-XX--X-XXX-
----XXXXXXX-XX-XXX--X-XXXXX---XX-X---XXXXX-X-XX-----X--X--XXX-X--X-XX--XX-XX-X-X-XXX---XXXXXX-XX-X----X-XXX-X-X-X---X-XXX-XXX-X--X----X-XX---XXXXXX-X-XX--X-XXX-
----XXXXXXX-XX-XXX-XXXXXXXX--XXX-X---XXXXX-X-XX-----X--X--XXX-X--X-XX--XX-XX-X-XXXXX---XXXXXX-XX-X----XXXXX-X-X-XX--X-XXX-XXX-X--X----X-XXX--XXXXXX-X-XX--X-XXX-
----XXXXXXX-XX-XXX-XXXXXXXXX-XXX-X---XXXXXXX-XX-----X--X--XXX-X--XXXX--XXXXXXXXXXXXX-XXXXXXXX-XX-X----XXXXX-X-X-XX-XXXXXX-XXX-X--X-X-XXXXXX--XXXXXX-X-XX--XXXXX-
----XXXXXXXXXX-XXX-XXXXXXXXX-XXX-X--XXXXXXXX-XX-----X--X--XXX-X--XXXXXXXXXXXXXXXXXXX-XXXXXXXX-XX-X----XXXXX-XXX-XXXXXXXXXXXXX-X--X-XXXXXXXX--XXXXXXXXXXX--XXXXX-
M-XXXXXXXXXXXX-XXXXXXXXXXXXX-XXX-X--XXXXXXXX-XXX-X--X--X--XXX-X--XXXXXXXXXXXXXXXXXXX-XXXXXXXX-XX-X-X--XXXXX-XXX-XXXXXXXXXXXXX-X--X-XXXXXXXX--XXXXXXXXXXX-XXXXXXF
X-XXXXXXXXXXXX-XXXXXXXXXXXXX-XXX-XX-XXXXXXXX-XXX-X-XX--XX-XXXXX-XXXXXXXXXXXXXXXXXXXX-XXXXXXXX-XX-XXXX-XXXXX-XXXXXXXXXXXXXXXXXXX--X-XXXXXXXXX-XXXXXXXXXXX-XXXXXXX
XXXXXXXXXXXXXXXXXXXXXXXXXXXXXXXXXXX-XXXXXXXXXXXXXX-XX--XX-XXXXXXXXXXXXXXXXXXXXXXXXXXXXXXXXXXXXXX-XXXXXXXXXX-XXXXXXXXXXXXXXXXXXXXXXXXXXXXXXXXXXXXXXXXXXXXXXXXXXXX
