----------------------------------------------------------------------------------------------------------------------------------------------------------------
-------------X---------X--------------------------------------------------------X--------------------X-------------------X------------XX------------------------
--------XXX--X-X-X-----X---------X---X------------XX----------------XX----------X--------------------X------------------XX--X----X----XX-----X------------------
--------XXX--X-X-X-----X---------X---X------X----XXX----------------XX-----X----X-X-------X----------X------------X-----XX--X--X-X----XX-----X--------------X---
--------XXX--X-X-X-----X---------X---X------X---XXXX-----X-------X--XXX----X----X-X--X----X----------X--X---------X-----XX-XX--X-XX--XXX---X-X------------X-X---
-X------XXX--X-X-X-----X-----X---X---X---X--X---XXXXX----X-----X-X--XXX-X--X----X-X--X----X-X--------XX-XX--------X-----XX-XX--X-XX--XXX---X-X------------X-XX--
-X-X----XXX--X-X-XX----X-X---X---X--XX---X--X---XXXXX----X-----X-X--XXX-XX-X----X-X--X--X-X-X---X----XX-XX--------X-X---XX-XX--X-XX--XXX---X-X------------X-XX--
-X-X---XXXX--X-XXXX----X-X---X---X--XX--XX--X---XXXXX----X----XX-XX-XXXXXX-X----X-X--X--X-X-X---XXX--XX-XX-X-X--X-X-X---XXXXX--X-XX-XXXX---X-XX-----X-----X-XX--
-X-X-X-XXXX--X-XXXX----XXX-X-X---X--XX--XX--X--XXXXXX----X----XX-XX-XXXXXX-X----X-X--XX-X-X-X---XXX-XXXXXX-X-X--X-X-X---XXXXX--XXXXXXXXX--XX-XXX----X-----X-XXX-
-X-X-XXXXXX--X-XXXX---XXXX-X-X---X-XXX--XX-XXXXXXXXXX-X--X----XX-XX-XXXXXX-X--XXX-X-XXX-X-X-X---XXX-XXXXXX-X-X--X-X-X---XXXXX--XXXXXXXXX--XX-XXX----X-----X-XXX-
-X-X-XXXXXX--XXXXXX---XXXX-X-X--XX-XXX--XX-XXXXXXXXXX-XX-X-X--XX-XX-XXXXXX-X-XXXX-X-XXX-X-X-X---XXX-XXXXXXXX-X--X-X-X---XXXXX--XXXXXXXXX--XX-XXX----X-----X-XXX-
-X-X-XXXXXX--XXXXXX---XXXXXX-X-XXX-XXX--XX-XXXXXXXXXX-XX-XXX--XX-XX-XXXXXX-X-XXXX-X-XXX-X-X-X---XXX-XXXXXXXX-X-XX-X-X---XXXXX--XXXXXXXXX--XX-XXX----X--XX-X-XXX-
-X-X-XXXXXXXXXXXXXX---XXXXXX-X-XXXXXXXX-XX-XXXXXXXXXXXXX-XXX--XX-XXXXXXXXX-X-XXXXXX-XXXXX-X-XXX-XXX-XXXXXXXX-X-XX-XXX-XXXXXXX-XXXXXXXXXX-XXX-XXX-X--X--XXXX-XXX-
MX-X-XXXXXXXXXXXXXXX--XXXXXX-X-XXXXXXXX-XX-XXXXXXXXXXXXXXXXX--XX-XXXXXXXXX-X-XXXXXX-XXXXX-X-XXX-XXX-XXXXXXXX-X-XXXXXX-XXXXXXXXXXXXXXXXXX-XXX-XXX-XX-XX-XXXX-XXXF
XXXX-XXXXXXXXXXXXXXX-XXXXXXX-X-XXXXXXXXXXX-XXXXXXXXXXXXXXXXX--XXXXXXXXXXXX-XXXXXXXX-XXXXXXXXXXX-XXX-XXXXXXXXXXXXXXXXXXXXXXXXXXXXXXXXXXXX-XXX-XXX-XX-XXXXXXX-XXXX
XXXXXXXXXXXXXXXXXXXXXXXXXXXX-XXXXXXXXXXXXX-XXXXXXXXXXXXXXXXXX-XXXXXXXXXXXX-XXXXXXXX-XXXXXXXXXXX-XXXXXXXXXXXXXXXXXXXXXXXXXXXXXXXXXXXXXXXX-XXX-XXX-XXXXXXXXXX-XXXX
