----------------------------------------------------------------------------------------------------------------------------------------------------------------
-----------------XX---------------------------X------------------------------------------------------X--------------------------------X--XX---------------------
-----------------XX--------------------------XX--------------------------------------X---------------X-----------------------------X--X--XX---------------------
----------------XXX----------------X-------XXXX------X-----------------------X-------X---------------X-------X-----X------X--------X--X--XX---------------------
-----------X----XXX----------------X-------XXXX------X-----------------------X-------X--X------------X-------XX----X------X--------X--X--XX--X-----X------X-----
-X--------XXX---XXX-----X----------X-------XXXX------X-------X---------X-----X------XX--X--X---------X-------XX----X------X---X----X--X--XXX-X--X--X------X-----
-X---X--X-XXX---XXX-----X--------X-XX------XXXX------X-------X---------X---X-X----X-XX--X--X-X-------X-------XX----X------XX--X----X--X--XXX-X--X--XX-----X-----
-X---X--X-XXX---XXX-----X--------X-XX------XXXX---X--X-------X--X------XX--X-X----X-XX--X--X-X-------X----X--XX----X---X--XX--X----X--X--XXX-X--X--XX-----X-----
-X---X--X-XXX--XXXX-----X------XXX-XX------XXXX---X--X---X--XX--X--X--XXX--X-X--X-X-XXXXX--X-X------XX----X-XXX--X-X--XX-XXX-XX----X--X--XXX-X--X--XX-----X-----
-X---X--X-XXX--XXXX-X---X------XXX-XX------XXXX---X-XX--XX--XX--X--X--XXXX-X-X--XXX-XXXXX--X-X-----XXX----X-XXX-XXXX--XX-XXX-XX----XX-X-XXXX-X--XX-XX--X--X-X---
-XXX-X--X-XXX--XXXX-X-X-X------XXX-XX-----XXXXX-XXXXXXX-XX--XX-XX--X--XXXX-XXX--XXX-XXXXX--X-X-----XXX----X-XXX-XXXX--XXXXXX-XX----XX-X-XXXX-XX-XX-XX--X--X-X---
-XXX-X-XX-XXX--XXXX-XXX-X--X---XXX-XX----XXXXXX-XXXXXXX-XX--XX-XX--XX-XXXXXXXX--XXX-XXXXX--X-X----XXXX----X-XXX-XXXX--XXXXXXXXX-X--XX-XXXXXX-XX-XXXXXXXXX-X-X---
-XXX-X-XX-XXX--XXXX-XXX-X-XX--XXXX-XX-X--XXXXXX-XXXXXXX-XXX-XX-XX--XX-XXXXXXXX--XXXXXXXXX--XXX----XXXXX---X-XXXXXXXX--XXXXXXXXX-XX-XXXXXXXXX-XXXXXXXXXXXX-X-X---
MXXX-X-XX-XXXX-XXXX-XXXXX-XXXXXXXX-XX-X--XXXXXX-XXXXXXX-XXXXXXXXX--XX-XXXXXXXX-XXXXXXXXXX-XXXXX--XXXXXXX--X-XXXXXXXX--XXXXXXXXX-XXXXXXXXXXXXXXXXXXXXXXXXX-X-XXXF
XXXX-XXXX-XXXX-XXXXXXXXXXXXXXXXXXX-XX-X--XXXXXX-XXXXXXXXXXXXXXXXX--XX-XXXXXXXXXXXXXXXXXXXXXXXXX-XXXXXXXXX-XXXXXXXXXX-XXXXXXXXXX-XXXXXXXXXXXXXXXXXXXXXXXXX-XXXXXX
XXXX-XXXXXXXXX-XXXXXXXXXXXXXXXXXXXXXXXXXXXXXXXXXXXXXXXXXXXXXXXXXXX-XXXXXXXXXXXXXXXXXXXXXXXXXXXX-XXXXXXXXXXXXXXXXXXXXXXXXXXXXXXXXXXXXXXXXXXXXXXXXXXXXXXXXX-XXXXXX
