----------------------------------------------------------------------------------------------------------------------------------------------------------------
---------------X------------------------X---------------------X----------------------X-----X----X--------------------------------X-----X--------------------X---
--X------------X-----------X--X---------X---------------------X----------------------X-----X----X-----X-----X---------X----------X-----X-------X------------X---
-XX------------X-----------XX-XXX-------X-X---------X---------X--X---X---------------X-----X--X-XX----X-----X--X------X----------X-----X-------X---X-----X--X---
-XX-X----------X---X-------XX-XXX-------X-X----X----X---------X--X---X-------X-------X-----XX-X-XX----X-----X--X------X----------X-----X------XX---X-----X--X---
-XX-XX---------X---X-------XX-XXX-X-----X-X---XX----XX--X--X--X-XX---X-------X-------X-----XX-X-XX--X-X-----X--XX--X-XX----------XX-X--X------XX--XX-X---X--X---
-XX-XX---------X---XX------XX-XXX-X-X---X-X---XX----XX--X--X--X-XX---X-------X------XX-----XX-X-XX--X-X-----X--XX--X-XX-----X----XXXX--X------XX--XX-X---X--X---
-XX-XX------X--X---XX----X-XX-XXX-X-X--XX-X---XX----XXX-X--X--X-XX---XX------X------XXX----XX-X-XX--X-X---X-X--XX-XX-XX-----X----XXXX-XX--X---XX--XX-X---X--X---
-XX-XX------X--X--XXX----X-XX-XXX-X-X-XXX-X---XX----XXX-X--X--XXXX---XX-----XX------XXX-X--XX-X-XX--X-X---XXX--XX-XX-XX-----XX---XXXX-XX--X--XXX--XX-XX--X-XX---
-XXXXX------X-XX--XXX----X-XX-XXX-X-X-XXX-X---XX----XXX-X--X--XXXX---XX---X-XX--X---XXX-X--XX-X-XX--X-X--XXXXX-XX-XXXXXX-X--XX-XXXXXXXXX-XX--XXX--XX-XXX-X-XX---
-XXXXX-X----X-XX--XXX-X--X-XX-XXX-X-X-XXXXX---XXXX--XXX-X--X--XXXX---XX---X-XX--X---XXX-X--XX-X-XX--X-X--XXXXXXXXXXXXXXX-X--XX-XXXXXXXXXXXX-XXXX--XXXXXX-XXXX---
-XXXXX-X---XX-XX--XXX-X--X-XX-XXX-XXX-XXXXX---XXXX--XXX-X-XX--XXXX-X-XX--XX-XX--X---XXX-X--XX-X-XX--X-X--XXXXXXXXXXXXXXX-X--XX-XXXXXXXXXXXX-XXXX--XXXXXX-XXXX---
-XXXXX-X--XXX-XX--XXXXX-XX-XXXXXX-XXX-XXXXXX--XXXX--XXX-X-XX--XXXX-X-XX--XX-XX--X---XXXXX--XX-X-XX--X-X--XXXXXXXXXXXXXXX-X--XX-XXXXXXXXXXXX-XXXX--XXXXXX-XXXX---
MXXXXXXX--XXX-XX--XXXXX-XXXXXXXXX-XXX-XXXXXX-XXXXX-XXXX-XXXX--XXXXXX-XX--XX-XX--X--XXXXXX-XXX-X-XXX-X-X--XXXXXXXXXXXXXXX-XXXXXXXXXXXXXXXXXX-XXXXX-XXXXXX-XXXXX-F
XXXXXXXX--XXXXXX--XXXXX-XXXXXXXXX-XXX-XXXXXX-XXXXX-XXXX-XXXXX-XXXXXXXXX-XXXXXX--XXXXXXXXX-XXX-X-XXX-X-X--XXXXXXXXXXXXXXXXXXXXXXXXXXXXXXXXXX-XXXXXXXXXXXXXXXXXX-X
XXXXXXXXXXXXXXXXXXXXXXX-XXXXXXXXXXXXXXXXXXXX-XXXXXXXXXX-XXXXX-XXXXXXXXX-XXXXXXXXXXXXXXXXXXXXX-XXXXXXX-X--XXXXXXXXXXXXXXXXXXXXXXXXXXXXXXXXXX-XXXXXXXXXXXXXXXXXX-X
