----------------------------------------------------------------------------------------------------------------------------------------------------------------
-----X-------------------X---X-X-X-------X-----------------------------X------X--X------XXX--------------------------------X------------------------------------
-----X------------------XX---X-XXX-------X--------X--------------X-----X------X--X-X----XXXX-------------------------------X----------------XX---------X--------
--XX-X---X--X----X--X---XX---X-XXXX--X---X--X-----X-X------------X-----X------X--X-X----XXXX-------------------------------X----------------XX-X-X-----X--X-----
--XX-X---X--XX---X--X---XX---X-XXXXX-X---XX-X-----X-X------------X--X--X------X--X-X----XXXX----------X------------------X-X----XX----------XX-X-X-----X-XXX----
--XX-X---X--XX---X--X---XX---X-XXXXX-X-X-XX-X--X--X-X--------XX--X--X--X------X--X-X----XXXX----------X---------XX-------X-X-X--XX-X-X------XX-X-XX-XX-X-XXX----
--XX-X---X--XX-X-X--X-X-XX---X-XXXXX-XXX-XX-X--X--X-X--X--X--XX-XX--X--X------X--X-X----XXXX-X--------X---------XX-------X-X-X--XX-XXX------XX-XXXX-XX-X-XXX-X--
--XXXX---X-XXX-XXXX-XXX-XX---X-XXXXX-XXX-XXXX--X--X-X--X-XX--XX-XX--X--X------X--X-X----XXXX-X-X-X----X-----X-X-XX------XX-X-X--XX-XXX------XX-XXXX-XX-X-XXX-X--
--XXXX-X-X-XXX-XXXX-XXXXXX--XX-XXXXXXXXXXXXXX--X--X-X--X-XXX-XX-XX--X--X--X---X--X-X---XXXXX-X-X-X----X-----X-X-XX------XX-X-X--XX-XXX-----XXX-XXXX-XX-X-XXX-XX-
--XXXX-X-X-XXX-XXXX-XXXXXX--XX-XXXXXXXXXXXXXX--X--X-X--X-XXX-XX-XX-XX--X--XX--X--XXX-X-XXXXX-X-XXX---XX-----X-X-XXX-----XX-X-X--XXXXXX-----XXX-XXXX-XX-X-XXX-XX-
--XXXX-X-X-XXX-XXXXXXXXXXX--XX-XXXXXXXXXXXXXX-XX--X-X--XXXXX-XX-XX-XX--X--XX-XXX-XXXXX-XXXXX-XXXXX---XX-X--XX-X-XXX-----XX-X-X--XXXXXXX----XXX-XXXX-XX-XXXXXXXX-
--XXXX-X-X-XXXXXXXXXXXXXXX--XX-XXXXXXXXXXXXXXXXXX-X-X--XXXXX-XX-XXXXX--X--XX-XXX-XXXXX-XXXXX-XXXXX-X-XX-X-XXX-X-XXX-----XXXX-X--XXXXXXX----XXXXXXXXXXX-XXXXXXXX-
--XXXX-XXX-XXXXXXXXXXXXXXX--XX-XXXXXXXXXXXXXXXXXX-X-X--XXXXX-XX-XXXXX--X-XXX-XXX-XXXXX-XXXXX-XXXXX-X-XX-X-XXX-X-XXX--X--XXXX-XXXXXXXXXX--X-XXXXXXXXXXX-XXXXXXXX-
M-XXXX-XXX-XXXXXXXXXXXXXXX--XX-XXXXXXXXXXXXXXXXXX-X-X--XXXXX-XX-XXXXX--X-XXX-XXX-XXXXX-XXXXX-XXXXX-X-XX-X-XXX-XXXXX--XX-XXXX-XXXXXXXXXX--XXXXXXXXXXXXX-XXXXXXXXF
X-XXXXXXXXXXXXXXXXXXXXXXXXX-XX-XXXXXXXXXXXXXXXXXX-X-X-XXXXXX-XX-XXXXX--X-XXXXXXXXXXXXX-XXXXX-XXXXXXXXXX-X-XXXXXXXXX--XXXXXXX-XXXXXXXXXX--XXXXXXXXXXXXX-XXXXXXXXX
X-XXXXXXXXXXXXXXXXXXXXXXXXXXXXXXXXXXXXXXXXXXXXXXX-X-XXXXXXXX-XX-XXXXXX-XXXXXXXXXXXXXXXXXXXXX-XXXXXXXXXXXXXXXXXXXXXX--XXXXXXXXXXXXXXXXXX--XXXXXXXXXXXXXXXXXXXXXXX
