----------------------------------------------------------------------------------------------------------------------------------------------------------------
-----------X--X-----------------------------------XX---------------------X--X-------X---------------------X-----------------------X-X---------------------------
--------X-XX--X-------------------X---------------XX----X---XX-----------X--X-------X-------X-X-----X-----XX-------X---X-------X--X-X---------------------------
-----X--X-XX--X----X--------------X------------X--XX----X-X-XX-X--X------X--X-------X-------X-X-----X-----XX-------X---X-------X--X-X-X---------------X--X------
-----X--X-XX--X----X-----XX-------X-X----------X--XX----X-X-XX-X--X------X--X-X-----X-------X-X-----XX----XX-------X---X----X--X--X-X-X----------X----X--X------
-----X--X-XX--X----X----XXX-------X-X-X--------X--XX----X-X-XX-X--X-X----X--X-X--X--X---X---X-XX----XX----XX-----X-X---X----X--X--XXX-X----X-----X----X--X------
-X---X--X-XX--X----X----XXX------XXXX-X--------X--XX----X-X-XX-X--X-X----XX-X-X--X--X---XX--X-XX----XX----XX----XX-X---X----X-XX--XXXXX----X--X--X----X--X------
-X---X--X-XX--X--X-X--X-XXX-----XXXXX-X--------X--XX-X--X-XXXX-X--X-X----XX-X-X--X--X---XX--XXXX----XX----XX----XX-X---X---XXXXX--XXXXX----XX-X--XX---X-XX------
-X---X--X-XXX-X--X-X--X-XXX---XXXXXXX-X----X---X--XX-X--X-XXXXXX-XX-X----XX-X-X--X--X--XXX--XXXX----XX----XX----XX-X---X---XXXXX--XXXXX----XX-XX-XX---X-XX----X-
-X---X--X-XXX-XX-X-XX-X-XXX---XXXXXXX-X----X---X--XX-X--X-XXXXXX-XX-X--X-XX-X-X--X--X--XXX--XXXX---XXX----XX----XX-X---X---XXXXXX-XXXXX----XX-XXXXX-X-XXXX----X-
-X-X-XX-X-XXXXXX-X-XX-X-XXX---XXXXXXX-X---XX---X--XX-X--X-XXXXXX-XX-X--X-XX-X-X--X--X--XXX--XXXXX-XXXX---XXX---XXX-X---X--XXXXXXX-XXXXX----XX-XXXXX-X-XXXX----X-
-X-X-XX-XXXXXXXX-XXXX-X-XXXX--XXXXXXXXX---XX---XX-XX-X--XXXXXXXX-XX-X--X-XXXX-X-XX--X--XXX--XXXXX-XXXX---XXX---XXX-X---X--XXXXXXX-XXXXX----XX-XXXXX-X-XXXX----X-
-X-X-XXXXXXXXXXX-XXXXXXXXXXX--XXXXXXXXX-X-XX---XX-XX-XXXXXXXXXXX-XXXX--X-XXXXXX-XXX-XX-XXX--XXXXX-XXXX--XXXX---XXX-X-X-X-XXXXXXXXXXXXXX-X--XX-XXXXX-X-XXXXX--XX-
MXXXXXXXXXXXXXXX-XXXXXXXXXXX--XXXXXXXXX-X-XX-X-XX-XXXXXXXXXXXXXX-XXXX--X-XXXXXX-XXX-XX-XXX--XXXXX-XXXX--XXXX---XXX-XXXXXXXXXXXXXXXXXXXXXXXXXXXXXXXX-X-XXXXXX-XXF
XXXXXXXXXXXXXXXXXXXXXXXXXXXX--XXXXXXXXXXX-XX-X-XXXXXXXXXXXXXXXXX-XXXXX-XXXXXXXXXXXX-XX-XXX--XXXXX-XXXX-XXXXXX-XXXX-XXXXXXXXXXXXXXXXXXXXXXXXXXXXXXXX-X-XXXXXX-XXX
XXXXXXXXXXXXXXXXXXXXXXXXXXXXXXXXXXXXXXXXX-XXXXXXXXXXXXXXXXXXXXXX-XXXXX-XXXXXXXXXXXXXXX-XXXX-XXXXX-XXXX-XXXXXX-XXXX-XXXXXXXXXXXXXXXXXXXXXXXXXXXXXXXX-X-XXXXXX-XXX
