----------------------------------------------------------------------------------------------------------------------------------------------------------------
--------------------X------XX------------X-X-----------X------------------------X-X--------------------------------X---------------X----------------------------
----------------XX--X------XX---X--X-----X-X-----------X-------X-------------X--X-X-------------------X------------X-------------X-X----------------------------
----X-X---------XX--X------XX---X--X-----X-X-------X---X-X-----X-------------X--X-X-------------------X------------XXX---------X-X-X-----------X----------------
---XX-X---------XX--X------XX---X--X-----X-X------XX-X-X-X---X-X--------X-X-XX--XXX---------X--------XX----X--X-X--XXX---------X-X-X-----X-----X----------------
---XX-X---------XX--X------XX---XX-X-----X-XX-----XX-X-X-X--XX-X----X---X-X-XX--XXX---------X--------XXX---X--X-X--XXX---------X-X-X----XX--X--X---X-------X----
---XXXX--XX---X-XX--X-----XXX---XX-X-----X-XX-----XX-XXX-X--XX-X----X---X-X-XX-XXXX-X-------X--------XXX---X-XX-X-XXXX------XX-X-X-X----XX--X--X---X-X-----X--X-
---XXXX--XX--XX-XX--X-----XXX---XX-X-----X-XX-----XX-XXX-X--XXXX----X---X-X-XX-XXXX-X-------X---X--X-XXX---X-XX-X-XXXX----X-XX-X-X-X----XX--X--XX--X-X----XX--X-
--XXXXX-XXX--XX-XX--X-----XXX---XX-X----XX-XX-X---XX-XXX-X-XXXXX----X-X-X-X-XX-XXXX-X-------X---X--X-XXX---X-XXXX-XXXX----XXXX-X-X-X-X--XX--X-XXX--X-X----XX-XX-
--XXXXX-XXXXXXX-XX--X-----XXXX--XX-X----XXXXX-X---XX-XXX-X-XXXXX----X-X-X-X-XX-XXXX-X-------XX--X-XX-XXX-X-X-XXXX-XXXX----XXXX-X-X-X-X--XX--XXXXX--X-X-X--XX-XX-
--XXXXX-XXXXXXX-XX--XX----XXXX--XX-X----XXXXX-X-X-XX-XXX-X-XXXXX----X-X-X-X-XX-XXXXXX---XX--XX--X-XX-XXX-X-X-XXXX-XXXX----XXXXXXXX-X-X--XX--XXXXX--X-X-X--XX-XX-
--XXXXX-XXXXXXX-XX-XXX----XXXX--XX-X-XX-XXXXX-X-X-XX-XXX-X-XXXXXX---XXX-X-X-XX-XXXXXX---XX--XX--X-XX-XXXXX-X-XXXXXXXXX----XXXXXXXX-X-X--XX--XXXXX--XXXXX--XX-XX-
--XXXXX-XXXXXXX-XXXXXX----XXXXXXXX-XXXXXXXXXX-X-X-XXXXXXXX-XXXXXX-X-XXX-XXX-XX-XXXXXX-X-XXX-XX--X-XX-XXXXX-XXXXXXXXXXX----XXXXXXXX-X-X-XXX--XXXXX--XXXXXXXXX-XX-
M-XXXXX-XXXXXXX-XXXXXXX-X-XXXXXXXXXXXXXXXXXXX-XXX-XXXXXXXX-XXXXXX-X-XXXXXXX-XXXXXXXXX-XXXXX-XX-XX-XXXXXXXXXXXXXXXXXXXXX---XXXXXXXX-X-X-XXX--XXXXX--XXXXXXXXX-XXF
X-XXXXX-XXXXXXXXXXXXXXXXXXXXXXXXXXXXXXXXXXXXX-XXXXXXXXXXXXXXXXXXX-X-XXXXXXX-XXXXXXXXX-XXXXX-XX-XX-XXXXXXXXXXXXXXXXXXXXX--XXXXXXXXXXXXX-XXX--XXXXX-XXXXXXXXXX-XXX
X-XXXXXXXXXXXXXXXXXXXXXXXXXXXXXXXXXXXXXXXXXXXXXXXXXXXXXXXXXXXXXXX-XXXXXXXXX-XXXXXXXXX-XXXXX-XX-XX-XXXXXXXXXXXXXXXXXXXXX-XXXXXXXXXXXXXXXXXX--XXXXXXXXXXXXXXXX-XXX
