----------------------------------------------------------------------------------------------------------------------------------------------------------------
--------------------------------------------------------------------------------------------------------------------------X-------------------X-----------------
---X-------------------------------------------X----------------X----------------------------X---------X------------------X-------------------X-----------X-----
---X--------X----------------------------------XX---X-----X-----X---------------------X------X---------X--X--X------------X-------------------X-----------X-----
---X--X-----X-------X----X-----------X---------XX---X-X---X---X-X---------------------X------X---------X--XX-X----X-------X----X--------------X----X------X-----
--XX--X---X-X-------X----X-----------X---------XX---XXX---X-X-X-X---------X-----------X------X-----X---X--XX-X----X-------X----X--X-----------X----X-X----X-----
-XXX--X---XXX-------X----X----X-X----X---------XX---XXX---XXX-XXX---------X--X--------XX--X--X-----X---X--XXXX----X-------X-X-XX--X-------X-X-X-X--X-X----X-----
-XXX--X---XXX-------X----X----X-X----X---------XX-X-XXX---XXX-XXX------X--XX-X--------XX--X--X-----X---X--XXXX----X-------XXX-XX--X-------X-X-X-X-XX-X----X-----
-XXX--X---XXX-----X-X----X----X-X----X---------XX-XXXXX---XXXXXXX----X-XX-XX-XX-------XX--X--X-X-X-X-XXX--XXXXX---X-------XXX-XX--XX------X-X-X-XXXXXX---XX--X--
-XXX--X---XXX-----X-X----X--X-XXX----X---------XX-XXXXX---XXXXXXXXX--X-XX-XX-XX----X--XXXXX--X-X-X-X-XXX--XXXXX---X-------XXX-XX--XX----XXXXX-X-XXXXXXX-XXX--X--
-XXX--X---XXX-----X-X--XXX--X-XXX--X-XX---X----XX-XXXXX---XXXXXXXXX--X-XX-XXXXX----XX-XXXXX--X-X-X-X-XXXX-XXXXX-X-XX---X--XXX-XX--XXX---XXXXX-XXXXXXXXX-XXX--X--
-XXX--X---XXX-----X-XX-XXX-XX-XXX--X-XX---X---XXXXXXXXXX--XXXXXXXXX--XXXX-XXXXXX---XX-XXXXX--X-X-XXX-XXXX-XXXXX-XXXX---X-XXXXXXX--XXX-X-XXXXX-XXXXXXXXX-XXX--X--
-XXXX-X---XXX--XX-X-XXXXXX-XX-XXX-XX-XX--XX---XXXXXXXXXXX-XXXXXXXXX--XXXXXXXXXXX---XXXXXXXXX-X-XXXXX-XXXXXXXXXX-XXXX--XX-XXXXXXX--XXX-XXXXXXX-XXXXXXXXX-XXX--X--
MXXXXXXX--XXX--XXXX-XXXXXX-XXXXXX-XXXXX-XXX---XXXXXXXXXXXXXXXXXXXXX--XXXXXXXXXXX---XXXXXXXXX-X-XXXXX-XXXXXXXXXX-XXXXX-XX-XXXXXXX--XXX-XXXXXXX-XXXXXXXXXXXXX--X-F
XXXXXXXXX-XXXXXXXXXXXXXXXXXXXXXXX-XXXXXXXXX---XXXXXXXXXXXXXXXXXXXXXX-XXXXXXXXXXX--XXXXXXXXXX-X-XXXXXXXXXXXXXXXX-XXXXXXXX-XXXXXXXX-XXX-XXXXXXX-XXXXXXXXXXXXXXXX-X
XXXXXXXXX-XXXXXXXXXXXXXXXXXXXXXXX-XXXXXXXXX--XXXXXXXXXXXXXXXXXXXXXXXXXXXXXXXXXXX--XXXXXXXXXXXX-XXXXXXXXXXXXXXXX-XXXXXXXXXXXXXXXXX-XXX-XXXXXXX-XXXXXXXXXXXXXXXX-X
