----------------------------------------------------------------------------------------------------------------------------------------------------------------
--X------------------X--------------------------X-----X------X----------------X-----X-----------X----X--------X--------X------------------X-----X---------------
--X---------X--------X--------X-----------------X-----X------X----------------X-----X-----------X----X----XX--X--------X-------------X----X----XX-----X-------X-
-XXX--------X--------X--------X-----X----------XX-----X------X---X---X--------X-----X-----XX--XXX---XX----XX--X---X----X---X----X----X----X----XX-----X----X--X-
-XXX--------X--------X------X-X-X-X-X--X-------XX-----X-X----X---X---X--------X-----XX--X-XX--XXXX-XXX----XX--X---X----X---X----X----X----X----XX-----X----XX-X-
-XXX-----X--X--------X------X-X-X-X-X--X-------XX-----X-X----X--XX---X--------X-----XX--X-XX--XXXX-XXX----XX--X---X---XX---X----X----X----X----XX-X---X----XX-X-
-XXX---X-X--X--X-----X------X-X-X-X-X--X--X--X-XX-----X-XX---X-XXX---X--------X-----XX--XXXX--XXXXXXXX----XX--X---X---XX-X-XX---X----X----X--X-XX-X---X--X-XX-X-
-XXX---X-X--X--X----XX-----XX-XXX-X-X--X--X--X-XX---X-XXXX---X-XXX---X--X-----XX----XX--XXXX--XXXXXXXX---XXXX-X---XXX-XXXX-XX---X----X---XXX-X-XX-X--XX--X-XX-X-
-XXXXX-X-X--X--X----XX-----XX-XXX-XXX--X--X--X-XX---X-XXXXX--X-XXX---X--X--X--XX----XX--XXXX--XXXXXXXX---XXXXXX---XXX-XXXX-XX---X---XX---XXX-X-XX-X--XX--XXXX-X-
-XXXXX-X-X-XX--X----XX-----XX-XXX-XXX--X--X-XX-XXX--XXXXXXXX-X-XXX--XX--X--X--XX--X-XX--XXXX-XXXXXXXXX---XXXXXX---XXX-XXXXXXX---X-XXXX---XXXXX-XXXX--XX--XXXX-X-
-XXXXX-X-XXXXX-X--X-XX-----XX-XXX-XXX--X--X-XX-XXX--XXXXXXXXXX-XXXX-XX--X--X--XX--XXXX--XXXX-XXXXXXXXX-X-XXXXXXX-XXXX-XXXXXXX---X-XXXX--XXXXXX-XXXX--XX--XXXX-X-
-XXXXX-XXXXXXX-X--XXXX-X-X-XXXXXX-XXX--X--X-XX-XXX--XXXXXXXXXXXXXXX-XX-XX--X--XX--XXXX-XXXXXXXXXXXXXXX-X-XXXXXXX-XXXX-XXXXXXX---XXXXXX--XXXXXXXXXXX-XXX--XXXXXX-
-XXXXX-XXXXXXX-X--XXXX-X-X-XXXXXX-XXX-XX--X-XXXXXXX-XXXXXXXXXXXXXXX-XX-XX-XX--XX--XXXXXXXXXXXXXXXXXXXX-XXXXXXXXXXXXXX-XXXXXXXX--XXXXXX--XXXXXXXXXXX-XXX--XXXXXX-
MXXXXX-XXXXXXXXXXXXXXX-X-X-XXXXXXXXXXXXX--X-XXXXXXXXXXXXXXXXXXXXXXXXXXXXXXXXX-XX--XXXXXXXXXXXXXXXXXXXX-XXXXXXXXXXXXXX-XXXXXXXX--XXXXXX--XXXXXXXXXXX-XXX--XXXXXXF
XXXXXX-XXXXXXXXXXXXXXX-X-X-XXXXXXXXXXXXX--X-XXXXXXXXXXXXXXXXXXXXXXXXXXXXXXXXX-XX--XXXXXXXXXXXXXXXXXXXX-XXXXXXXXXXXXXX-XXXXXXXXXXXXXXXXX-XXXXXXXXXXX-XXX--XXXXXXX
XXXXXXXXXXXXXXXXXXXXXXXX-XXXXXXXXXXXXXXXX-X-XXXXXXXXXXXXXXXXXXXXXXXXXXXXXXXXXXXXX-XXXXXXXXXXXXXXXXXXXX-XXXXXXXXXXXXXXXXXXXXXXXXXXXXXXXX-XXXXXXXXXXX-XXXXXXXXXXXX
