----------------------------------------------------------------------------------------------------------------------------------------------------------------
---------------------------X------------------------------X----------X------------XX-------X--------X--------------X----------X---X--X--------------------------
-----------------X----X----X--------------X---------------X---X------X------------XX---X---X----X---X----X-----X---X----------X---XX-X--X-X--------------X------
-X--------------XX----X----X--------------X-X------------XX---X------X----X------XXX--XXX--X--X-X---X---XX-----X--XX--X-------X---XX-XX-X-X----------X---X------
-X--------------XX----X----X-------X------X-X---X--X--X--XX---X------X-X--X------XXX--XXX--X--X-X---X---XX--X--X--XX--X-------X--XXX-XXXX-X----------X---X------
-X-------X-----XXX----X----X-------X------X-X---X--X--X--XX--XX------XXX-XX---X--XXX--XXX--X--X-X---X---XX--X--X--XX--X-------X-XXXX-XXXX-X----------X---X-X----
-X---X---X-----XXX----X----X---X---X------X-X---X--X--XX-XX--XXX-----XXX-XX-X-X--XXX--XXX--X--X-X---X---XX--X--X--XX--X-------X-XXXX-XXXX-X-------X--X---X-X----
-X---X--XX--X--XXXXX--X----XX--X---X--X---X-X---X--X--XX-XX--XXX-----XXX-XX-X-X--XXXX-XXX--X--X-X---X---XX-XX--X--XXX-X-------X-XXXX-XXXX-X-------X--X---X-X----
-X-X-X--XX--X--XXXXX--X----XX--X---X--XX--X-X---XX-X--XX-XX--XXX--X--XXX-XX-XXX--XXXX-XXXX-XX-X-X---X---XX-XX-XX-XXXX-X-X-----X-XXXXXXXXX-X--X----X--X---XXX----
-X-X-X-XXXX-X--XXXXX--X----XX--X-X-XX-XX-XX-XX--XX-X--XX-XX--XXX--X-XXXX-XX-XXX--XXXX-XXXX-XXXX-X---X---XXXXX-XX-XXXX-X-XX----X-XXXXXXXXX-X-XX----X--X---XXXX-X-
-XXX-X-XXXX-X-XXXXXX--X---XXX--X-XXXXXXX-XX-XXX-XX-X--XXXXX--XXX-XX-XXXX-XX-XXX--XXXX-XXXXXXXXX-X-X-X---XXXXX-XXXXXXX-XXXX----X-XXXXXXXXX-X-XX----X--X---XXXXXX-
-XXX-X-XXXX-X-XXXXXX--X---XXX--X-XXXXXXX-XX-XXXXXX-X--XXXXX--XXX-XX-XXXX-XX-XXXX-XXXX-XXXXXXXXX-X-X-X---XXXXX-XXXXXXX-XXXX----X-XXXXXXXXX-X-XX----X--X---XXXXXX-
-XXXXX-XXXX-XXXXXXXX--XX-XXXX--XXXXXXXXX-XXXXXXXXX-X--XXXXX-XXXXXXXXXXXX-XX-XXXX-XXXX-XXXXXXXXX-X-X-X-XXXXXXXXXXXXXXX-XXXX-X--X-XXXXXXXXX-X-XX--X-XX-X---XXXXXX-
MXXXXX-XXXXXXXXXXXXX--XX-XXXX-XXXXXXXXXX-XXXXXXXXX-X--XXXXXXXXXXXXXXXXXX-XXXXXXXXXXXX-XXXXXXXXX-XXX-X-XXXXXXXXXXXXXXX-XXXX-X-XX-XXXXXXXXX-XXXX-XXXXX-X---XXXXXXF
XXXXXX-XXXXXXXXXXXXX--XX-XXXX-XXXXXXXXXX-XXXXXXXXXXX-XXXXXXXXXXXXXXXXXXX-XXXXXXXXXXXXXXXXXXXXXX-XXX-XXXXXXXXXXXXXXXXX-XXXXXXXXXXXXXXXXXXXXXXXX-XXXXX-X---XXXXXXX
XXXXXXXXXXXXXXXXXXXX--XX-XXXXXXXXXXXXXXX-XXXXXXXXXXX-XXXXXXXXXXXXXXXXXXX-XXXXXXXXXXXXXXXXXXXXXXXXXX-XXXXXXXXXXXXXXXXX-XXXXXXXXXXXXXXXXXXXXXXXX-XXXXXXX-XXXXXXXXX
