----------------------------------------------------------------------------------------------------------------------------------------------------------------
----X-----------------------X--X------X--------X----X-----------X------------------------------------------X------------X---------------------------------------
----X-------------X---------X--X---X--X--------X----X-----------X------------X----------------X------------X---------X-XX-------------------X-----X-----X---X---
----X-------------X--------XX--X---X--X-X------XX---X--------X--X------------X----X-----------X------------X---------X-XX------------X------X-----X-----X---X---
----X-X-----X-----X----X-X-XX-XX---X--X-X----X-XX---X--------X--X------------XX---X-X----XXX--X-X----------X---------X-XX------------X------X-----X-----X-X-X---
--X-X-X-----X-----X----X-X-XX-XX---X--X-X----X-XXX--X---X----X--X------------XX---X-X----XXX--X-X----X-----X---------X-XX------X-----X-X----X-----X-----X-X-X---
--X-X-X-----X-----XX---X-XXXXXXX---X--X-X----X-XXX--X---X----X--X-----------XXX---X-X----XXXX-X-X-X--X-----X--------XX-XX------X-----X-X----X-----X--X--X-X-X-X-
--X-X-XX--X-X-----XX---X-XXXXXXX---X--X-X----X-XXX--X---X----X--X------X----XXX-X-X-XX---XXXXXX-X-X--X-----X--X-X---XX-XX------X--X--X-X---XX--X--X--XX-XXX-X-X-
-XX-X-XX-XX-X--XX-XX---X-XXXXXXX---X--X-X----X-XXX-XX---X----X--X------XX---XXX-X-X-XX---XXXXXX-X-X--X-----X--X-X---XX-XX--X---X--X--XXX---XX-XX--X--XX-XXX-X-X-
-XX-X-XX-XX-X--XX-XX---X-XXXXXXX---X--X-X----X-XXX-XX---XX---X--X------XX---XXXXX-X-XX---XXXXXXXX-X-XXX----X--X-XX--XX-XX--XX-XX--XXXXXX---XX-XX--X--XX-XXX-X-X-
-XX-X-XXXXXXX-XXX-XX---X-XXXXXXX---XX-X-X----XXXXX-XX---XX---X--X------XX-X-XXXXX-X-XX-X-XXXXXXXX-X-XXX----X--X-XX--XX-XX--XXXXX--XXXXXXX--XX-XX--X-XXX-XXX-X-X-
-XX-X-XXXXXXX-XXXXXX--XX-XXXXXXX--XXX-X-X-X--XXXXX-XX---XXX-XXX-X------XX-X-XXXXXXX-XX-X-XXXXXXXXXX-XXX--X-X--X-XX--XX-XX-XXXXXXX-XXXXXXX-XXXXXX--X-XXX-XXX-X-X-
-XX-X-XXXXXXX-XXXXXX--XX-XXXXXXX--XXX-X-X-X--XXXXX-XX---XXX-XXX-X------XXXXXXXXXXXX-XXXX-XXXXXXXXXX-XXXX-X-X-XX-XX--XX-XX-XXXXXXX-XXXXXXXXXXXXXX-XXXXXXXXXXXX-X-
MXX-X-XXXXXXX-XXXXXX--XX-XXXXXXXX-XXX-X-X-X-XXXXXX-XX---XXX-XXXXXX-XX--XXXXXXXXXXXX-XXXX-XXXXXXXXXX-XXXXXX-X-XX-XX--XX-XX-XXXXXXX-XXXXXXXXXXXXXX-XXXXXXXXXXXX-XF
XXX-X-XXXXXXXXXXXXXX--XXXXXXXXXXX-XXX-X-X-XXXXXXXX-XX---XXX-XXXXXX-XXX-XXXXXXXXXXXX-XXXXXXXXXXXXXXX-XXXXXX-X-XX-XX--XXXXX-XXXXXXXXXXXXXXXXXXXXXX-XXXXXXXXXXXXXXX
XXXXXXXXXXXXXXXXXXXX-XXXXXXXXXXXXXXXX-XXX-XXXXXXXX-XX---XXXXXXXXXX-XXX-XXXXXXXXXXXXXXXXXXXXXXXXXXXX-XXXXXXXX-XXXXXXXXXXXX-XXXXXXXXXXXXXXXXXXXXXXXXXXXXXXXXXXXXXX
