----------------------------------------------------------------------------------------------------------------------------------------------------------------
----X-----X---------------------XX-----------X----------X-----------------------------------------------------------X---------------X---------------------------
----X-----XX--------------X-----XXX---------XX----X-----X-----------------------X---X-------X-----------------------X---------------XX-----X--------------X-----
----X-----XX--------------X-----XXX---------XX----XX----X--X--------------------X---X-----X-X--X--X---------------X-X--------------XXX-----X--------------X-----
----X-----XX-----X-X-X--X-X--X--XXX---------XX----XX----XX-X-----------X----X---X---X-----X-X--X--X-----X---------X-X--X-----------XXX-----X--------------X-----
-X--XXX---XX-----XXXXX--X-X--XX-XXX---X-----XXX--XXX----XX-X-----------X---XX---X---X-----X-X--XX-XX----X---------X-X--XX----------XXX-----X---------X----X-----
-X--XXX---XX-----XXXXX--X-XX-XX-XXX-XXX-----XXX--XXX----XX-X-----X-----X---XX--XX---X-----X-X--XX-XXX---XX-X-X-X-XX-X--XX----------XXX-----X---------X----X---X-
-X--XXXX--XX-----XXXXX--X-XX-XX-XXXXXXX-----XXX--XXX----XX-X-----X-----X---XX-XXX---X-----X-X--XX-XXX---XX-X-X-XXXX-X--XX-X--------XXX-----X------X--X--XXXX--X-
-X--XXXXX-XXX----XXXXX--X-XX-XX-XXXXXXX-----XXX--XXX-X--XX-X--X--X-----X-X-XXXXXX-X-X-----X-X-XXX-XXX---XX-X-X-XXXX-X--XXXX----X---XXX-----X------X--XX-XXXX--X-
-X--XXXXX-XXX----XXXXX--X-XX-XX-XXXXXXX-----XXX-XXXX-X--XX-X--X--X-X---X-X-XXXXXX-X-X----XX-X-XXX-XXXX--XX-X-X-XXXX-X--XXXX-X--X---XXX---X-X------X--XXXXXXX--X-
-X--XXXXX-XXX----XXXXX--X-XX-XX-XXXXXXX-----XXX-XXXX-XX-XX-X-XX--X-X-X-X-X-XXXXXX-X-X----XX-XXXXXXXXXX--XX-X-X-XXXX-X--XXXX-X--XX--XXX---X-X------XX-XXXXXXX--X-
-X-XXXXXX-XXX--X-XXXXX--X-XX-XXXXXXXXXX-----XXX-XXXX-XX-XX-XXXX--X-X-XXX-X-XXXXXX-X-X---XXX-XXXXXXXXXX--XX-X-X-XXXX-X--XXXX-X--XX-XXXX-XXX-X------XX-XXXXXXX--X-
-X-XXXXXX-XXX--X-XXXXXX-X-XX-XXXXXXXXXXX--X-XXX-XXXXXXXXXX-XXXX--X-X-XXX-X-XXXXXX-XXX-X-XXX-XXXXXXXXXX--XX-X-X-XXXX-XXXXXXX-X--XX-XXXX-XXXXX---X--XX-XXXXXXX--X-
MX-XXXXXX-XXX--X-XXXXXX-XXXX-XXXXXXXXXXX--XXXXX-XXXXXXXXXX-XXXX--X-X-XXX-XXXXXXXX-XXX-X-XXX-XXXXXXXXXX-XXX-X-XXXXXX-XXXXXXX-X--XX-XXXX-XXXXXX--X--XX-XXXXXXX-XXF
XX-XXXXXXXXXXX-X-XXXXXXXXXXX-XXXXXXXXXXX--XXXXXXXXXXXXXXXX-XXXX-XX-X-XXX-XXXXXXXX-XXX-X-XXXXXXXXXXXXXX-XXX-X-XXXXXXXXXXXXXX-X--XXXXXXXXXXXXXX-XXX-XXXXXXXXXX-XXX
XX-XXXXXXXXXXX-XXXXXXXXXXXXXXXXXXXXXXXXXXXXXXXXXXXXXXXXXXXXXXXX-XX-XXXXXXXXXXXXXX-XXX-X-XXXXXXXXXXXXXXXXXXXXXXXXXXXXXXXXXXX-XXXXXXXXXXXXXXXXX-XXX-XXXXXXXXXXXXXX
