----------------------------------------------------------------------------------------------------------------------------------------------------------------
-----------X-----------X--------------X----------X----------------------------------------X------------------------X------------------X----X------X-------------
-------X---XX-----X-X--X----X---------X----------X------------X-----------X---------------X---------------X--XX----X---------X--------X----X------X----------X--
-------X-X-XX-----X-X--X----X---------X----------X---X--------X-----------X------------X--XX-X------------X--XX----X---X-----X--X---XXXX-X-X------X---X------X--
-------X-X-XX-----X-X--X----XX----X---X-------X--X---X------X-XX----------X-----X----X-X--XX-X------------X--XX----X---X--X--X--X---XXXX-X-X------X---X------X--
-------X-X-XX-----X-X--X----XXX---X---X----X--X--X---X------X-XX-X--------X-----X----X-X--XX-X----X-------X-XXXXX--X---X--X--X--X---XXXX-X-X--X---X---X---X--X--
----X--X-X-XXX----X-X--X----XXX---X---X----X--X--X---X--X---X-XX-X----X---X-----XX---X-X--XX-XX---X----X--X-XXXXX-XX---X-XX--X--X---XXXX-X-X--X---X---X---X--X--
----XX-X-XXXXX----X-X--X----XXXXX-X---X----X-XX--X---X-XX---X-XX-X----X---X-----XX---X-XX-XX-XX-X-X----X--X-XXXXX-XX---X-XX--X--X---XXXX-XXX--X---X---X---X--XX-
----XX-X-XXXXX----X-X--X----XXXXX-X---X----X-XX--X---X-XX---XXXX-XX---XX--X--X--XX---X-XX-XX-XX-X-X----X--X-XXXXX-XXX--X-XX--XX-X--XXXXX-XXX--X---X---X--XX--XX-
----XX-XXXXXXX--X-X-XX-X-X--XXXXX-X---X----X-XX--X---X-XX---XXXX-XX-X-XX--X--X--XX---X-XXXXX-XX-X-X----X--X-XXXXX-XXX--X-XXX-XX-X--XXXXX-XXX--X---X---X-XXX--XX-
----XXXXXXXXXX--X-XXXXXX-XX-XXXXX-X---X----X-XX--X-X-X-XX--XXXXXXXXXX-XX-XX-XX-XXX---X-XXXXX-XXXX-X----X-XX-XXXXX-XXX--X-XXX-XX-X--XXXXX-XXX--X---X---X-XXX-XXX-
----XXXXXXXXXX--X-XXXXXX-XX-XXXXX-X---X--X-X-XX--X-X-X-XX-XXXXXXXXXXX-XX-XX-XX-XXX---X-XXXXX-XXXX-X----X-XX-XXXXX-XXX--X-XXX-XX-X--XXXXX-XXX--X---X---X-XXX-XXX-
----XXXXXXXXXX--X-XXXXXX-XX-XXXXX-X-XXX--XXX-XX--X-XXX-XXXXXXXXXXXXXX-XX-XX-XX-XXX---X-XXXXX-XXXX-X--X-X-XX-XXXXX-XXX--X-XXX-XX-X--XXXXX-XXX--X---XX--X-XXX-XXX-
M---XXXXXXXXXXX-XXXXXXXX-XXXXXXXX-X-XXXX-XXXXXXXXX-XXX-XXXXXXXXXXXXXX-XX-XX-XX-XXX---X-XXXXX-XXXX-X-XX-X-XX-XXXXX-XXX--X-XXX-XX-X--XXXXX-XXX--XX--XX-XX-XXX-XXXF
XX-XXXXXXXXXXXX-XXXXXXXXXXXXXXXXXXX-XXXX-XXXXXXXXX-XXXXXXXXXXXXXXXXXXXXX-XXXXX-XXX--XX-XXXXX-XXXXXX-XXXX-XXXXXXXX-XXX-XX-XXX-XX-XX-XXXXX-XXX-XXXX-XXXXXXXXX-XXXX
XXXXXXXXXXXXXXX-XXXXXXXXXXXXXXXXXXX-XXXX-XXXXXXXXX-XXXXXXXXXXXXXXXXXXXXX-XXXXX-XXX--XX-XXXXX-XXXXXX-XXXX-XXXXXXXX-XXX-XXXXXXXXXXXX-XXXXX-XXXXXXXX-XXXXXXXXXXXXXX
