----------------------------------------------------------------------------------------------------------------------------------------------------------------
-------X-----X--------------------------X-X--------------X--------XX-X-----------X------------------------------X--------------------------------X--------------
-------X-----XX-------------------------X-X-------------XX----X---XX-X-----------X--X------------X----XX-X------XX---X-----------X-------------X-X--------X---X-
----X--X-----XX---------X---------------X-X---X---------XX----X---XX-X---------X-X--X------------X----XXXX---X--XX---X-----------X-----------X-X-X--------X---X-
----XX-XX----XX--X------X-----XX--------X-X---X-------X-XX----X---XX-X---X-----X-X-XX-----X------X---XXXXX---X--XXX--X-----------X-X---------X-X-X-X-----XX---X-
----XX-XX----XX--X----X-X-----XX---X----X-XX--X-------X-XX----X---XX-X---X-----X-X-XX-----X--X--XX---XXXXXX--X--XXX--X--------X--X-X-----X---X-X-X-X-X---XX---X-
----XX-XX----XXX-X----X-X-----XX---X----X-XX--XX------X-XX----XX--XX-X---X-X---X-X-XX-----X--X--XX---XXXXXX--X--XXX--X-X------X--X-X-----X---X-X-X-X-X---XX-X-X-
----XX-XX--X-XXX-X----X-X-----XXX-XX----X-XX--XX------X-XXX-X-XX-XXX-X--XX-X---X-X-XX----XXXXX--XX-X-XXXXXX--X--XXX--X-X---X--X--X-X-----X---X-X-X-X-X--XXX-X-X-
-X--XX-XX--X-XXX-X----X-X-----XXXXXX----X-XX--XX------X-XXX-X-XX-XXXXX--XXXX---X-X-XX--X-XXXXX--XX-XXXXXXXX--X--XXX--X-X---X--X--X-X-----X---XXX-X-X-X--XXX-X-X-
-X--XX-XX--X-XXXXX-X--X-X-----XXXXXX---XX-XX-XXX------X-XXX-X-XX-XXXXX--XXXX---X-X-XX--X-XXXXX-XXX-XXXXXXXX--X--XXX--XXX--XX--X--X-XX----X---XXX-X-X-XX-XXX-X-X-
-X--XX-XX--XXXXXXXXXX-X-X---X-XXXXXXX--XX-XXXXXXXX----XXXXX-X-XXXXXXXXX-XXXXX-XX-XXXX--X-XXXXX-XXX-XXXXXXXX--X-XXXX--XXX--XX--X--XXXX---XX---XXX-X-X-XX-XXX-X-X-
-X--XX-XX--XXXXXXXXXX-X-X---X-XXXXXXX--XX-XXXXXXXX---XXXXXX-X-XXXXXXXXX-XXXXXXXX-XXXX--X-XXXXX-XXX-XXXXXXXX--X-XXXX--XXX--XX--X--XXXXX--XX---XXX-X-X-XX-XXXXX-X-
-X--XX-XXX-XXXXXXXXXX-X-XX--X-XXXXXXX--XX-XXXXXXXX---XXXXXX-X-XXXXXXXXX-XXXXXXXXXXXXX--X-XXXXX-XXX-XXXXXXXX--XXXXXX--XXXX-XXX-X--XXXXXX-XX-X-XXX-X-X-XX-XXXXX-X-
MX--XX-XXX-XXXXXXXXXX-XXXX--X-XXXXXXX-XXX-XXXXXXXX-X-XXXXXX-X-XXXXXXXXX-XXXXXXXXXXXXX--X-XXXXX-XXXXXXXXXXXX-XXXXXXXXXXXXX-XXX-XXXXXXXXX-XX-X-XXX-XXX-XX-XXXXX-XF
XX--XX-XXX-XXXXXXXXXXXXXXX--X-XXXXXXXXXXX-XXXXXXXX-X-XXXXXX-XXXXXXXXXXX-XXXXXXXXXXXXX--X-XXXXX-XXXXXXXXXXXXXXXXXXXXXXXXXX-XXX-XXXXXXXXX-XX-X-XXX-XXXXXX-XXXXXXXX
XXX-XX-XXXXXXXXXXXXXXXXXXX-XX-XXXXXXXXXXX-XXXXXXXX-X-XXXXXX-XXXXXXXXXXX-XXXXXXXXXXXXXX-X-XXXXXXXXXXXXXXXXXXXXXXXXXXXXXXXXXXXX-XXXXXXXXXXXX-X-XXX-XXXXXXXXXXXXXXX
