----------------------------------------------------------------------------------------------------------------------------------------------------------------
----------------------------------------------------------------X-X--X-------XX------------------------------X---------------X-------------------------X--------
---------------X-------X----------------------------------------X-X--XX------XX------------------------------X-----------X---X----------------------X--XX-------
-----X---------X--X---XX-XX--------X----------------------------X-X--XX-X----XX-------------------X----------X-----------X--XX-----X----------------X--XXX------
-----X---XX----X--X---XX-XX--------XX----------------X--------XXX-X--XX-X---XXX------------------XX-X--XX----XX----------X--XX---XXX----------------X--XXX------
-----X---XX----X--X---XX-XX------X-XX-------XX----X--X--------XXXXX--XX-X---XXX---XX--------X----XX-X--XX----XX----------X--XX---XXX---X---------X--X--XXX--X---
----XX--XXX----X--X--XXX-XX---X--X-XX-------XX----X--X--X-----XXXXX--XX-X---XXX---XX--X-----X----XX-X--XX----XX----------XX-XX---XXX---X--------XX-XX--XXX-XX-X-
----XX--XXX----X--X--XXX-XX---X-XX-XX-X-----XX----X-XX--X-----XXXXX--XX-X---XXX---XX--X--X--X----XX-X--XX----XX--------X-XX-XX---XXX---X-X----X-XX-XX--XXX-XX-X-
-X--XX--XXX----X--X-XXXX-XX---X-XXXXX-X-----XX----X-XX--X-----XXXXX--XX-X---XXX---XX--X--X--X----XX-X--XX----XX-------XXXXX-XX---XXX---X-XX---X-XX-XX--XXX-XX-X-
-X--XX--XXX----XX-X-XXXX-XX---X-XXXXXXX----XXXX--XX-XX--X---X-XXXXX--XX-X---XXX---XX-XX--X--X-X--XX-X--XX----XX-------XXXXX-XX---XXX--XX-XX---X-XX-XX--XXX-XXXX-
-X-XXX--XXX----XX-X-XXXX-XX---XXXXXXXXX----XXXX--XXXXX--X--XX-XXXXX--XX-XX--XXX---XXXXXX-XX-X-X--XX-X-XXX----XX------XXXXXX-XX---XXX-XXX-XXX--X-XX-XX--XXX-XXXX-
-XXXXX-XXXX---XXX-X-XXXXXXX---XXXXXXXXX----XXXXX-XXXXX--X--XX-XXXXX--XX-XX--XXXX--XXXXXXXXX-X-X--XX-X-XXX----XXX----XXXXXXX-XX---XXX-XXX-XXX--X-XX-XX--XXX-XXXX-
-XXXXX-XXXX---XXX-X-XXXXXXX--XXXXXXXXXX--X-XXXXX-XXXXX--X--XX-XXXXX-XXX-XX-XXXXXX-XXXXXXXXX-X-X--XX-X-XXX----XXXX--XXXXXXXX-XXXX-XXX-XXXXXXX--XXXXXXX--XXX-XXXX-
MXXXXXXXXXXX--XXXXX-XXXXXXX--XXXXXXXXXX--XXXXXXXXXXXXX-XX-XXX-XXXXXXXXXXXX-XXXXXXXXXXXXXXXX-X-X--XX-X-XXX----XXXXX-XXXXXXXX-XXXX-XXXXXXXXXXX--XXXXXXXX-XXX-XXXXF
XXXXXXXXXXXX--XXXXX-XXXXXXXXXXXXXXXXXXX--XXXXXXXXXXXXX-XX-XXX-XXXXXXXXXXXX-XXXXXXXXXXXXXXXX-XXX-XXX-XXXXX----XXXXX-XXXXXXXXXXXXX-XXXXXXXXXXX--XXXXXXXXXXXX-XXXXX
XXXXXXXXXXXX-XXXXXXXXXXXXXXXXXXXXXXXXXX--XXXXXXXXXXXXX-XX-XXXXXXXXXXXXXXXX-XXXXXXXXXXXXXXXX-XXX-XXXXXXXXXXX-XXXXXX-XXXXXXXXXXXXXXXXXXXXXXXXX-XXXXXXXXXXXXXXXXXXX
