----------------------------------------------------------------------------------------------------------------------------------------------------------------
-------------------------------------------X----------------------------------------------X-----------------------------------X---------X-----------------------
----------------------------XX-------------X---------X----X--X----------------------------X---------------X-------------------X-X-------X-------------X---------
--X----------X-----------X--XX-----------X-X-X-------X---XX--X-X--------------------------X---------------X--------X----------X-X-------X-------------X---------
--X-------X--X--X--------X--XX---X-------X-X-XX-X----XXX-XX--X-X-X-----X------X--X--------X---------------X--------X-------X-XX-X-------X--XX---X-----X---------
--X-------X--X--X--------X--XX---X-------X-X-XX-X----XXX-XX--XXX-X-----X------X--X-X--XX--X-------------X-XX-------XX------X-XX-XX--X---X--XX---X-----XX-X------
--X-------X--X--X-------XX--XX---X-------X-X-XX-X----XXXXXX-XXXX-X-----X------X--X-X--XX--X-------------X-XX-------XX----X-X-XX-XXX-X---X--XX---X---X-XX-X------
--X-XX----X--XX-X--X-X--XX--XX---X----X--X-X-XXXX---XXXXXXX-XXXXXX-----X------X--X-X-XXX--XX----------X-XXXX-------XX----X-X-XX-XXXXX---X--XX---X---X-XXXX------
--X-XX----X--XX-XX-X-X--XX--XX---X--XXX--X-X-XXXX---XXXXXXX-XXXXXX--X-XX---X-XXX-X-X-XXX--XXX---------XXXXXX----X--XX----X-X-XX-XXXXX---X--XXX--X---X-XXXX------
--X-XX----X--XXXXX-X-X-XXX--XX---X--XXX--X-X-XXXX---XXXXXXX-XXXXXXX-XXXX---X-XXX-X-X-XXX--XXX-------X-XXXXXXX---X-XXX----X-X-XXXXXXXXX-XX--XXX--X---X-XXXX------
--X-XX---XX--XXXXX-X-X-XXX-XXX---X-XXXXX-X-X-XXXXX--XXXXXXX-XXXXXXX-XXXX-X-X-XXX-X-X-XXX--XXX-X-----X-XXXXXXXX--X-XXX---XX-X-XXXXXXXXX-XX--XXX--X---X-XXXX------
-XX-XX---XX--XXXXX-X-X-XXX-XXX---XXXXXXX-X-X-XXXXXX-XXXXXXX-XXXXXXX-XXXX-X-X-XXX-X-X-XXX-XXXX-X-----X-XXXXXXXXX-X-XXX---XX-X-XXXXXXXXX-XX--XXX-XX-X-X-XXXX--X---
-XXXXX---XX--XXXXX-X-X-XXX-XXX---XXXXXXXXXXX-XXXXXX-XXXXXXX-XXXXXXX-XXXX-X-X-XXX-XXX-XXX-XXXX-X--X--X-XXXXXXXXX-XXXXX-X-XX-X-XXXXXXXXX-XX--XXXXXX-XXX-XXXX--X---
MXXXXX---XXX-XXXXX-X-XXXXX-XXX--XXXXXXXXXXXX-XXXXXX-XXXXXXX-XXXXXXX-XXXXXX-X-XXX-XXX-XXX-XXXX-X--X--X-XXXXXXXXX-XXXXX-XXXX-X-XXXXXXXXXXXX--XXXXXX-XXX-XXXX-XX--F
XXXXXX---XXXXXXXXX-XXXXXXX-XXX--XXXXXXXXXXXX-XXXXXX-XXXXXXXXXXXXXXX-XXXXXXXX-XXXXXXXXXXXXXXXX-X-XXX-X-XXXXXXXXXXXXXXX-XXXXXX-XXXXXXXXXXXX--XXXXXX-XXX-XXXX-XX-XX
XXXXXX--XXXXXXXXXX-XXXXXXXXXXXX-XXXXXXXXXXXX-XXXXXXXXXXXXXXXXXXXXXXXXXXXXXXX-XXXXXXXXXXXXXXXXXX-XXXXX-XXXXXXXXXXXXXXXXXXXXXX-XXXXXXXXXXXX--XXXXXXXXXXXXXXXXXXXXX
