----------------------------------------------------------------------------------------------------------------------------------------------------------------
----X----X---X---X-----------------------------------------X----------------X---------X--------------------X--X--------------------------------------------X-X--
-X-XX--X-X---X---X----X--------------------------------X---X----------------X------X-XX------------X------XX--X-------------------X-----------X---------X--XXX--
-X-XX--X-X---X---X----X---------------------------X----X---X---------------XX------X-XX-----X------X-X----XX--X-----X--------XX---X-----X-----X----X--X-X--XXX--
-X-XX--X-X---X---X----X--------X------------------X---XXX--X---------------XX----X-X-XX-----X----X-X-X----XX--X-----X-XX-----XX---X-X---X----XX----X--X-X--XXX--
-X-XX--X-X---X-XXX----X---X----X-------------X----X---XXX--X---------------XX----X-X-XX-----X----X-X-XX---XXX-XX--X-X-XX-----XX---X-X---X---XXX----X--X-XX-XXX--
-X-XXX-XXX---X-XXX----X---X----X--X--XX-XX---X----X-X-XXX-XX-X-------------XX----X-X-XX-----X-X--X-X-XX---XXX-XX--X-X-XX--X-XXX-X-X-X---X---XXX----X--X-XXXXXX--
-X-XXX-XXX---X-XXX-X--X---XX---X--X--XX-XX---X--X-X-X-XXX-XX-XX---------X--XX---XX-X-XXX--X-X-XX-X-X-XX---XXX-XXX-X-XXXX--X-XXX-XXX-X---X---XXX----X--X-XXXXXX--
-X-XXX-XXX---X-XXXXX--X---XX---X--X--XX-XX--XX--X-X-X-XXX-XX-XX---------X-XXX-X-XX-X-XXXX-X-X-XXXX-X-XX-X-XXX-XXX-X-XXXX--X-XXX-XXXXX---X---XXX-X--X--X-XXXXXX--
-X-XXX-XXXX--X-XXXXXX-X---XXX-XXX-X--XX-XX--XX--XXX-X-XXX-XXXXX---------XXXXX-X-XX-X-XXXX-X-X-XXXXXX-XX-X-XXX-XXX-X-XXXX--X-XXX-XXXXX---X---XXX-X--X--XXXXXXXX--
-X-XXX-XXXX--X-XXXXXX-X---XXX-XXX-X--XX-XX-XXXX-XXX-X-XXX-XXXXX---X---X-XXXXX-X-XX-X-XXXXXX-X-XXXXXX-XX-X-XXX-XXX-X-XXXX--X-XXX-XXXXX--XX---XXXXX--X-XXXXXXXXX--
-X-XXXXXXXX--X-XXXXXX-XXX-XXX-XXX-X--XXXXX-XXXX-XXX-X-XXX-XXXXX--XXXXXX-XXXXX-X-XXXX-XXXXXXXXXXXXXXX-XX-X-XXX-XXXXXXXXXX-XX-XXX-XXXXX--XX---XXXXXX-X-XXXXXXXXX--
-X-XXXXXXXX--XXXXXXXX-XXX-XXX-XXX-X-XXXXXX-XXXX-XXX-X-XXX-XXXXX--XXXXXXXXXXXX-X-XXXXXXXXXXXXXXXXXXXX-XX-X-XXX-XXXXXXXXXX-XXXXXX-XXXXXXXXX---XXXXXX-XXXXXXXXXXX--
MXXXXXXXXXXXXXXXXXXXX-XXX-XXXXXXX-X-XXXXXX-XXXX-XXX-X-XXX-XXXXX--XXXXXXXXXXXX-X-XXXXXXXXXXXXXXXXXXXX-XXXX-XXX-XXXXXXXXXX-XXXXXX-XXXXXXXXX---XXXXXXXXXXXXXXXXXXXF
XXXXXXXXXXXXXXXXXXXXX-XXX-XXXXXXX-X-XXXXXX-XXXX-XXXXXXXXX-XXXXXX-XXXXXXXXXXXXXXXXXXXXXXXXXXXXXXXXXXX-XXXX-XXXXXXXXXXXXXX-XXXXXX-XXXXXXXXXXXXXXXXXXXXXXXXXXXXXXXX
XXXXXXXXXXXXXXXXXXXXX-XXXXXXXXXXX-XXXXXXXX-XXXX-XXXXXXXXX-XXXXXX-XXXXXXXXXXXXXXXXXXXXXXXXXXXXXXXXXXX-XXXX-XXXXXXXXXXXXXXXXXXXXXXXXXXXXXXXXXXXXXXXXXXXXXXXXXXXXXX
