----------------------------------------------------------------------------------------------------------------------------------------------------------------
---------X---X------------------------------------------------X-X-------------X---------X---X-----X------------------------X------------------------X-----X-----
----X-X--X---X-----X--X--------X-----------X----------XXX-----X-X-------------X----X---XX---X---X-X-XX---------------------X------------------------X-----X-----
----X-X--X---X-----X--X-X------X---X-------X--------X-XXX-----X-XX-----------XX----X---XX---X---X-X-XX---X-----------------X-----X------X-----------X--X--X-----
---XX-X--X---XX--X-X--XXXX-----X-X-X------XX--------X-XXX--X--XXXX---X-------XX----X---XX---X---X-X-XX--XX------X-------X--X-----X------X-----------X--X--X-----
-X-XX-X--X---XX--X-X--XXXX-----X-X-XX-----XX--------X-XXX--X--XXXX---X-------XX----X---XX---X---X-X-XX--XX------XX------X--X-----X------X------X----X--X--X-----
-X-XX-X--X---XX--X-X--XXXX-----X-X-XX-----XX--------X-XXX--X--XXXX---X-------XX----X---XX---X---X-X-XXX-XXX-----XX------X--X-----X------X------X----X--X--X-----
-X-XX-X--X---XX-XX-X-XXXXX-----X-X-XX----XXX-------XX-XXX--X--XXXX---X----X--XX----X---XX---X---X-X-XXXXXXX-----XX------XXXX-X--XXX-X--XX------X--X-X--X--X---X-
-X-XX-X--X---XX-XX-X-XXXXX----XX-X-XXX---XXX--X----XX-XXX--XX-XXXX---X-X--X-XXX----X-XXXX---X--XX-X-XXXXXXX-----XX-X----XXXX-X--XXX-X-XXX------X--X-XX-X--X---X-
-X-XX-X--X-X-XX-XX-X-XXXXX--X-XX-XXXXX---XXX--X----XXXXXX--XX-XXXX-X-X-X--X-XXX--X-X-XXXX---X-XXX-X-XXXXXXX-----XX-X----XXXX-X--XXX-XXXXX---X--X--X-XX-X--X---X-
-XXXX-XX-X-X-XX-XX-X-XXXXX--X-XX-XXXXX---XXX--X----XXXXXX--XX-XXXX-X-X-X-XX-XXX--X-X-XXXXX--X-XXXXXXXXXXXXX-----XX-X-X--XXXX-XXXXXX-XXXXX---X--X--X-XX-X--X---X-
-XXXX-XXXX-XXXX-XX-XXXXXXX--X-XX-XXXXX---XXX--X----XXXXXX--XX-XXXX-X-X-X-XX-XXX-XX-X-XXXXX--X-XXXXXXXXXXXXX--X--XXXXXX--XXXX-XXXXXX-XXXXX---X--X--X-XX-XX-X---X-
-XXXX-XXXX-XXXXXXX-XXXXXXX--X-XX-XXXXX---XXX--X----XXXXXX--XX-XXXX-X-X-X-XX-XXX-XXXX-XXXXX--X-XXXXXXXXXXXXX--X--XXXXXX--XXXX-XXXXXX-XXXXX-X-X--X-XX-XX-XX-XX--X-
MXXXX-XXXXXXXXXXXXXXXXXXXXX-X-XX-XXXXXX--XXXX-X----XXXXXX--XX-XXXX-XXX-X-XX-XXX-XXXX-XXXXX--X-XXXXXXXXXXXXX--XX-XXXXXX--XXXX-XXXXXX-XXXXX-X-XX-X-XX-XX-XX-XX--XF
XXXXX-XXXXXXXXXXXXXXXXXXXXX-X-XX-XXXXXX--XXXXXX-X--XXXXXX--XX-XXXX-XXX-X-XX-XXXXXXXX-XXXXXX-X-XXXXXXXXXXXXXX-XX-XXXXXXX-XXXXXXXXXXX-XXXXX-X-XXXX-XX-XX-XX-XXX-XX
XXXXX-XXXXXXXXXXXXXXXXXXXXXXX-XXXXXXXXXXXXXXXXXXX-XXXXXXXX-XXXXXXXXXXX-X-XXXXXXXXXXXXXXXXXX-X-XXXXXXXXXXXXXXXXXXXXXXXXX-XXXXXXXXXXX-XXXXXXXXXXXXXXX-XX-XX-XXX-XX
