----------------------------------------------------------------------------------------------------------------------------------------------------------------
----X-------------------X--------------X----------------------------------------X----------------------------------------X--X--------------------X--------------
----X----------------X--X-----------X--X--------------------------------X--X----X---------------X---------X--------------X--X------------------XXX--------X-----
----X----------------X--X-----------X--X--------------------------------X--X---XX--X--X--X------X---------X-----X-------XX--XX------X------X--XXXX-----X--X---X-
----X---------X------XX-X-----------X--X------------------------X-------X--X---XX--XX-X--XX-X---X--------XX-----XX----X-XX--XX------X--X---XX-XXXX-X---X--X---X-
-X--X----X--XXX------XX-X------X---XX--X-------XX---------------X-------X--X---XX-XXX-X--XX-X---X--------XX--X--XX----X-XX-XXX------X--X---XX-XXXX-XXX-X--X---X-
-X--X----X--XXX------XX-X----X-X---XX--X-------XXX--------------XX------X--X-X-XX-XXX-X--XX-X--XXX-------XX--X-XXX----X-XX-XXX-----XX--XX-XXX-XXXX-XXX-X--XX--X-
-X-XX----X--XXX------XX-X----X-X---XX--X-------XXX------X-------XX------X--X-X-XX-XXX-X--XX-X--XXX-------XX--X-XXX----X-XX-XXX-----XX--XX-XXX-XXXXXXXX-X--XX--X-
-X-XX----X--XXX--X--XXX-XX---X-XX--XX--X----XX-XXX------X---X---XX----X-X--X-X-XX-XXX-X-XXX-X--XXX-X-X-X-XX--X-XXXX---X-XX-XXX-XX--XX--XX-XXXXXXXXXXXX-X--XX--X-
-X-XXX---XX-XXX--X--XXX-XX---X-XX--XX--XX---XX-XXX------XXX-X---XX-X--X-X--X-X-XX-XXX-X-XXXXXX-XXX-X-X-X-XX--X-XXXXX--X-XX-XXX-XX--XX--XX-XXXXXXXXXXXXXX--XX--X-
-X-XXX---XX-XXX--XX-XXX-XX---X-XX-XXX-XXX---XX-XXX-----XXXX-X---XXXX--X-X--X-X-XX-XXX-X-XXXXXX-XXXXX-XXX-XX--X-XXXXX--X-XX-XXX-XX--XX--XXXXXXXXXXXXXXXXX--XX--X-
-X-XXX--XXX-XXX--XX-XXX-XX---X-XX-XXXXXXX--XXX-XXX---X-XXXX-X-XXXXXX--X-X--X-X-XX-XXX-X-XXXXXX-XXXXX-XXX-XX--X-XXXXXX-X-XX-XXX-XX--XX--XXXXXXXXXXXXXXXXX--XX--X-
-X-XXX-XXXXXXXX--XXXXXX-XXX--XXXX-XXXXXXX--XXX-XXX---X-XXXX-X-XXXXXX--X-X--X-X-XX-XXX-XXXXXXXX-XXXXX-XXX-XX--X-XXXXXX-X-XX-XXX-XX--XX-XXXXXXXXXXXXXXXXXX--XXX-X-
MX-XXX-XXXXXXXX--XXXXXX-XXXX-XXXX-XXXXXXXXXXXXXXXX---X-XXXX-X-XXXXXXX-XXXXXX-X-XX-XXX-XXXXXXXX-XXXXX-XXXXXX-XXXXXXXXX-X-XX-XXXXXX--XX-XXXXXXXXXXXXXXXXXX--XXX-XF
XX-XXXXXXXXXXXXXXXXXXXXXXXXXXXXXXXXXXXXXXXXXXXXXXXXXXXXXXXX-X-XXXXXXX-XXXXXX-X-XX-XXX-XXXXXXXX-XXXXX-XXXXXXXXXXXXXXXX-X-XXXXXXXXX-XXX-XXXXXXXXXXXXXXXXXX-XXXX-XX
XXXXXXXXXXXXXXXXXXXXXXXXXXXXXXXXXXXXXXXXXXXXXXXXXXXXXXXXXXX-X-XXXXXXX-XXXXXXXXXXXXXXX-XXXXXXXXXXXXXX-XXXXXXXXXXXXXXXXXX-XXXXXXXXX-XXX-XXXXXXXXXXXXXXXXXX-XXXXXXX
