----------------------------------------------------------------------------------------------------------------------------------------------------------------
-------------X--------XX----------------------XX--------------X--X--------------------------------------------X---------------------XX--------------X-----------
-------------X--------XX------X-------X---X---XX--------------X-XX---X-----------------------X-X----X---------X---------------------XX--------------X-X---X-----
-------------X--------XX------X-------X---X---XX---------X----X-XX---X--------------------XX-X-X--X-XX--------XX--------------X--X--XX--------XX----X-X--XX--X--
-X--X-X-----XX--------XX------XX---X--X---X---XX---------X----X-XX---X--------------------XX-X-X--X-XX------X-XX-------------XX--X--XX-------XXX----X-X-XXX--XX-
-X--X-X----XXX--------XX--X---XX--XX--X---X---XX-X-X-----X----X-XX---X----X----------X---XXX-XXX--X-XX----X-X-XX-X-----------XX--X--XX------XXXX----X-X-XXX--XX-
-X--XXX----XXXX-------XX--X---XX--XX--X---XX--XX-X-X-----X----X-XX---X----X-------X-XX---XXX-XXXX-X-XX----X-X-XX-X---X-------XX--X-XXX-X----XXXX----X-XXXXX--XX-
-X-XXXX---XXXXX----X-XXX--X---XX--XX--X---XX--XX-X-X-----X-X--X-XX---XX--XX-------X-XXX--XXXXXXXX-X-XX-X-XX-X-XX-X---XX------XX--X-XXX-X----XXXX----X-XXXXX--XX-
-X-XXXX---XXXXX----X-XXXX-X---XX--XX--X---XX--XX-X-X-----X-X--X-XX---XX--XX-------XXXXXX-XXXXXXXX-X-XX-XXXX-X-XXXX---XX----X-XX--X-XXXXX--X-XXXX----X-XXXXX--XX-
-X-XXXX---XXXXX----X-XXXXXX---XX--XX--XX--XX--XX-XXX----XX-X-XX-XX---XX--XX-------XXXXXX-XXXXXXXX-X-XX-XXXX-X-XXXX---XX----X-XXX-XXXXXXX--X-XXXX----X-XXXXX--XX-
-X-XXXX--XXXXXX----X-XXXXXX--XXXX-XX--XX--XXX-XX-XXX----XX-XXXX-XX---XXX-XX-------XXXXXXXXXXXXXXX-X-XX-XXXX-X-XXXX---XX----X-XXX-XXXXXXX--X-XXXX----X-XXXXX-XXX-
-X-XXXX--XXXXXX--X-X-XXXXXX--XXXXXXXX-XX--XXX-XX-XXX-XXXXX-XXXX-XX---XXX-XX--X---XXXXXXXXXXXXXXXX-XXXX-XXXX-X-XXXXXX-XX---XX-XXX-XXXXXXX--X-XXXXX-XXX-XXXXXXXXX-
-X-XXXX--XXXXXX--X-X-XXXXXXX-XXXXXXXX-XX--XXX-XX-XXX-XXXXX-XXXX-XX---XXX-XX--XX--XXXXXXXXXXXXXXXXXXXXX-XXXX-X-XXXXXXXXXX-XXX-XXX-XXXXXXXX-X-XXXXX-XXX-XXXXXXXXX-
MX-XXXX-XXXXXXX--X-X-XXXXXXX-XXXXXXXXXXX--XXX-XX-XXX-XXXXX-XXXX-XX--XXXXXXX-XXX-XXXXXXXXXXXXXXXXXXXXXX-XXXXXX-XXXXXXXXXX-XXX-XXX-XXXXXXXX-XXXXXXX-XXX-XXXXXXXXXF
XX-XXXXXXXXXXXX-XX-X-XXXXXXX-XXXXXXXXXXX--XXX-XXXXXXXXXXXXXXXXX-XX--XXXXXXX-XXX-XXXXXXXXXXXXXXXXXXXXXX-XXXXXX-XXXXXXXXXX-XXX-XXXXXXXXXXXX-XXXXXXX-XXX-XXXXXXXXXX
XX-XXXXXXXXXXXX-XXXXXXXXXXXX-XXXXXXXXXXX-XXXXXXXXXXXXXXXXXXXXXX-XX--XXXXXXXXXXXXXXXXXXXXXXXXXXXXXXXXXX-XXXXXX-XXXXXXXXXXXXXX-XXXXXXXXXXXX-XXXXXXXXXXXXXXXXXXXXXX
