----------------------------------------------------------------------------------------------------------------------------------------------------------------
-----------------------------------------X----X----------------X--------------------------X----------X-----X--------------XX--X------X---X------------X---------
---------X-------------------------------X----X--X-------------X--------X-------X---------X----------X-----X--------------XX--X------X---X------------X---------
---------X-------------X-----------------X----X--X------X--XX--X--------X-------X---------X----------X-----X--------------XX--X---X--X---X------X-----X---------
-------X-X-------------X---X-------------X----X-XX------X--XX--X--------X-------XX-------XX---XX-----X-----X-X------------XX--X---X--X---X--X---X-----X---------
------XX-X------X------X---X-------------X----X-XX------X--XX--X--------X--X----XX----X--XX---XX--X--X---X-X-X-----------XXX--X---X--X---X--X---X-----X---------
------XX-X-X----X----X-X---X-------------X----X-XX---X--X--XXX-X--------X--X----XX----X--XX---XX-XXX-X---X-X-X---X-----X-XXX-XX---X--X---X--X---X----XX---------
-----XXX-X-X----XX---X-X---X-X-----------X--X-X-XX---X--X--XXX-X--------XX-X----XX--X-XX-XX---XXXXXXXX-X-X-X-X---X-----X-XXX-XXX--X--X---X-XX---X----XX---XX--X-
-----XXX-XXX----XX---X-X-X-X-X--------X--X--X-X-XX-X-X--X--XXX-X----X---XX-X-X-XXX--X-XXXXX---XXXXXXXX-X-X-X-X-X-X-----X-XXX-XXX--X--X---X-XX---X--X-XX---XX--X-
---X-XXX-XXX----XX---X-X-X-X-X--------X--X--X-XXXX-X-X-XX--XXX-X--XXXX--XXXX-X-XXXX-X-XXXXX---XXXXXXXX-XXX-XXX-X-X-----X-XXX-XXX--X--X---XXXX---X--X-XX---XX--X-
--XX-XXX-XXX----XX---XXX-X-X-X--------X--XX-X-XXXX-X-X-XXX-XXX-X--XXXX--XXXX-X-XXXX-X-XXXXX---XXXXXXXXXXXX-XXX-X-X-----X-XXX-XXX-XXX-X---XXXX---X--X-XX---XX--X-
--XX-XXX-XXX--X-XX--XXXX-X-X-X-X-XX-X-X--XX-X-XXXX-XXX-XXX-XXX-X--XXXX-XXXXXXX-XXXX-X-XXXXX---XXXXXXXXXXXX-XXX-X-X-----X-XXX-XXX-XXX-XX--XXXX---X--X-XX--XXX--X-
--XX-XXX-XXXX-X-XX--XXXX-X-X-X-X-XX-X-X--XX-X-XXXX-XXX-XXX-XXX-X-XXXXX-XXXXXXXXXXXXXX-XXXXX-X-XXXXXXXXXXXX-XXX-X-X-XX--X-XXXXXXX-XXX-XX-XXXXX---X-XX-XX--XXX-XX-
MXXX-XXX-XXXX-XXXXX-XXXX-X-X-XXX-XX-X-X--XX-X-XXXXXXXXXXXX-XXX-X-XXXXXXXXXXXXXXXXXXXX-XXXXX-XXXXXXXXXXXXXX-XXXXX-X-XX--X-XXXXXXX-XXX-XX-XXXXXX--X-XX-XX--XXXXXXF
XXXXXXXXXXXXXXXXXXX-XXXXXXXX-XXX-XX-XXX--XX-X-XXXXXXXXXXXXXXXXXXXXXXXXXXXXXXXXXXXXXXX-XXXXXXXXXXXXXXXXXXXX-XXXXX-X-XX--X-XXXXXXXXXXX-XX-XXXXXXXXXXXX-XXX-XXXXXXX
XXXXXXXXXXXXXXXXXXX-XXXXXXXXXXXXXXXXXXX-XXX-X-XXXXXXXXXXXXXXXXXXXXXXXXXXXXXXXXXXXXXXXXXXXXXXXXXXXXXXXXXXXXXXXXXX-XXXXXXX-XXXXXXXXXXX-XXXXXXXXXXXXXXXXXXXXXXXXXXX
