----------------------------------------------------------------------------------------------------------------------------------------------------------------
--------------X---------------------------XX----X-------X------X----X----------------------X----------X--------X------X--------------X--------------------------
--XX----------XX-----X-----X----X---------XX----X-------X--X--XX----X-----------------X----X-----X----X--------X------X--------------X--------X-X---------------
--XXX---------XX-----X-----X----X---------XX----X------XX--XX-XX---XX--------------X--XX---X-----X----X--------X------X-------------XX--------X-X---------------
--XXX--------XXX-X---X-----X----X-X-------XX----X---X--XX--XXXXX---XX--------------X--XX---X-----X----X--------X-X--X-X-------------XX--------X-X---X--------X--
--XXX--------XXX-X---X-----X----X-X-------XX----X---X--XX--XXXXX---XX------X-------X--XX---X-X---X----X--------X-X--X-X-------------XX-X-----XX-X---X--X-----X--
--XXXX-------XXX-X---X-X---X--X-X-X-------XX-X--X---X--XX--XXXXX---XX------X-------X--XX---X-X-X-X----X--------XXX--X-X-----X-------XX-XX----XXXX---X--X----XXX-
--XXXX----X--XXX-X---X-X---X--X-X-X-X---XXXX-X--X---X--XXX-XXXXX---XX------X----X--X--XX---X-X-X-X----X----X---XXXX-X-X---X-X----X--XX-XX---XXXXX---X--X----XXX-
--XXXX----X--XXX-XX-XX-X--XX--X-X-X-X--XXXXX-X--X---XX-XXX-XXXXX---XX--X-X-X---XX--X--XX-X-X-X-X-X---XX----X---XXXXXX-X---X-X----X--XX-XX---XXXXXX--X--X----XXX-
--XXXXX---X--XXX-XX-XX-X--XX--X-X-X-X--XXXXX-XX-X---XX-XXX-XXXXX---XX--X-XXX---XXX-X-XXX-X-X-X-X-X---XX----X---XXXXXX-X---XXX--X-X-XXX-XXX-XXXXXXX--X--X--X-XXX-
--XXXXX-X-X--XXX-XX-XX-XX-XXX-X-X-X-X-XXXXXX-XX-X---XX-XXXXXXXXX---XX--X-XXX--XXXXXX-XXX-X-X-X-X-X---XX----X---XXXXXX-X--XXXX--X-X-XXXXXXX-XXXXXXX-XX--X-XX-XXX-
--XXXXX-X-X--XXX-XX-XXXXX-XXX-X-X-X-X-XXXXXXXXX-X-XXXXXXXXXXXXXX---XX--X-XXX--XXXXXX-XXX-X-X-X-X-X---XX----X---XXXXXX-X--XXXX--X-X-XXXXXXX-XXXXXXX-XX--X-XX-XXX-
--XXXXX-XXX--XXX-XX-XXXXX-XXX-X-XXX-X-XXXXXXXXX-X-XXXXXXXXXXXXXX-X-XX--XXXXX-XXXXXXX-XXX-X-X-XXX-X---XX----X---XXXXXX-XX-XXXX--X-X-XXXXXXX-XXXXXXX-XX-XX-XX-XXX-
M-XXXXXXXXX-XXXX-XXXXXXXX-XXX-XXXXX-X-XXXXXXXXX-X-XXXXXXXXXXXXXX-X-XX-XXXXXX-XXXXXXX-XXX-XXXXXXXXX-X-XX-X--X-X-XXXXXXXXX-XXXX--X-X-XXXXXXX-XXXXXXXXXX-XX-XXXXXXF
X-XXXXXXXXX-XXXX-XXXXXXXX-XXX-XXXXXXX-XXXXXXXXX-XXXXXXXXXXXXXXXXXX-XX-XXXXXX-XXXXXXX-XXX-XXXXXXXXXXX-XXXX--XXX-XXXXXXXXX-XXXX--X-XXXXXXXXX-XXXXXXXXXXXXX-XXXXXXX
XXXXXXXXXXXXXXXXXXXXXXXXX-XXX-XXXXXXX-XXXXXXXXXXXXXXXXXXXXXXXXXXXX-XXXXXXXXXXXXXXXXX-XXXXXXXXXXXXXXXXXXXXXXXXXXXXXXXXXXX-XXXX-XXXXXXXXXXXX-XXXXXXXXXXXXX-XXXXXXX
