----------------------------------------------------------------------------------------------------------------------------------------------------------------
----X---X--X-X-----X-------------------------------------------------------------------------X-----------------------------------X------------------X-------XX--
----X--XX--X-X-----X------------------------------------------X---X--X------------------X----X----------------------------X------X------------------X-------XX--
----X--XX--X-X----XX------------------------------X-------X---X---X--X-----------X------X----X---------------X------------X------X------------------X-------XXX-
----X--XX--X-X----XX--X-----X---------------------X-------X---X---X--X---------X-X------X----X---------------X------------X------X----X--------X--X-X-------XXX-
----X--XX--X-X----XX--X---X-X--------------X------X-------X---X---X--X------X--X-X------X----X-----------X---X---X-X----X-X------XX---X--X--X--X--X-X-------XXX-
----X--XX--X-X----XX--X---X-X--X-------X---X------X--X----X---X---X--X------X--X-X------X----X---------X-X-X-X-X-XXX----X-X--X---XX---X--XX-X--X--X-X-------XXX-
----X-XXX--X-X-X--XXX-X---X-X--X-------X---X-----XX--X----X---XX--XX-X-X----X--X-X------X----X------X--X-X-X-X-XXXXXX---X-XX-X---XX---X--XX-X--XX-X-X-XX----XXX-
----X-XXX--XXX-X--XXXXX---X-XX-X-----XXX---X-----XX--X----X-X-XX--XX-X-X----X--X-X------X---XX------X--X-X-X-X-XXXXXX---X-XX-XX--XX---X--XX-X--XX-X-X-XX----XXX-
----X-XXX--XXX-X-XXXXXX-X-X-XX-X----XXXX---X-----XX--X--X-X-X-XX--XX-X-XX---X--XXX------X---XXX-----X--X-X-X-X-XXXXXX---X-XX-XX--XX--XX--XX-X--XX-X-X-XX----XXX-
----X-XXX-XXXX-X-XXXXXX-X-X-XXXX---XXXXXX--XX----XX--X--X-X-X-XX--XX-X-XX--XX--XXX---X-XX---XXX---XXX--X-X-X-X-XXXXXX---X-XX-XX--XXX-XXX-XX-X--XX-X-X-XX----XXX-
----X-XXX-XXXX-X-XXXXXXXX-X-XXXX---XXXXXXX-XX----XX--X--X-XXX-XX--XX-X-XX--XX--XXX---X-XX---XXXX-XXXX--X-X-XXX-XXXXXX---X-XX-XXX-XXX-XXX-XX-X--XX-X-X-XX----XXX-
--X-X-XXX-XXXX-X-XXXXXXXX-X-XXXX---XXXXXXX-XX-X--XX--X--X-XXX-XX-XXX-X-XX--XX--XXX---X-XX---XXXX-XXXX-XX-X-XXX-XXXXXX---X-XX-XXXXXXX-XXX-XXXXX-XX-XXX-XXXX--XXX-
M-XXX-XXXXXXXX-XXXXXXXXXX-XXXXXX--XXXXXXXX-XX-X--XX-XXX-X-XXX-XX-XXX-X-XX--XX--XXXXX-X-XX-X-XXXX-XXXX-XX-X-XXX-XXXXXX--XX-XXXXXXXXXXXXXX-XXXXX-XX-XXX-XXXX--XXXF
XXXXXXXXXXXXXX-XXXXXXXXXX-XXXXXX--XXXXXXXXXXX-X--XX-XXXXX-XXX-XX-XXXXX-XX--XX--XXXXXXX-XX-X-XXXXXXXXX-XXXX-XXX-XXXXXXX-XXXXXXXXXXXXXXXXX-XXXXX-XXXXXXXXXXX-XXXXX
XXXXXXXXXXXXXX-XXXXXXXXXX-XXXXXX--XXXXXXXXXXXXXX-XXXXXXXX-XXX-XXXXXXXXXXX-XXX-XXXXXXXXXXXXX-XXXXXXXXXXXXXXXXXXXXXXXXXXXXXXXXXXXXXXXXXXXX-XXXXXXXXXXXXXXXXX-XXXXX
