----------------------------------------------------------------------------------------------------------------------------------------------------------------
-------------XX-------------------X----------X------X------X-----------------------------------X-----------X--------------X------------X---------------X--------
--------X----XX-----X-------------X--------X-XX-----X--X---X---------------------X-X-----------X---X-------X----X----X---XX----X----X--XX------X-------X-X------
---X----X----XX-----X-------------XX-------X-XX-----X--X-XXX-X-------------------X-X-----------X---XX------X----X----X---XX--X-X----X--XX------X-------XXX------
---X----X----XX-----X-------------XX-------XXXX-----X--X-XXX-X-----------------X-XXXX----------X---XX------X----XX---X---XX--X-X----X--XX------X-XX----XXX------
---X----X----XX-----X-----------X-XX------XXXXX-----X--X-XXX-X-----X----X----X-X-XXXX----------X---XX-XX---X----XX---X---XX--X-XX---X--XX------X-XXX---XXX--X---
---X----X----XX-----X-X--X------X-XX---X--XXXXX--X--X--X-XXX-X----XX----X----X-X-XXXX------X---X---XX-XX---X----XX---X---XX--X-XX-X-XX-XX------X-XXX---XXX--X---
---X----X----XX-X---XXX--XX---X-X-XX---X--XXXXX--X--XX-X-XXX-X----XX-X--X----X-X-XXXX---X-XX---X---XX-XX---X--X-XXX--X---XX--X-XX-X-XX-XX-----XXXXXX-X-XXX--X---
--XXX---X----XX-X---XXX--XX---X-X-XX---X--XXXXX-XXXXXX-X-XXX-X---XXX-X--X----XXX-XXXX--XX-XX---X---XX-XX---X--X-XXX--X---XX--X-XX-XXXX-XX-----XXXXXX-X-XXX-XXX--
--XXX--XXX---XX-X---XXX--XX---X-X-XX---XXXXXXXX-XXXXXX-X-XXX-X-X-XXX-X--X----XXXXXXXX--XX-XX---X---XX-XX---X--X-XXX--X-X-XX--X-XX-XXXX-XX----XXXXXXX-X-XXX-XXX--
--XXX-XXXX---XX-X---XXX--XX---X-X-XXX--XXXXXXXX-XXXXXX-X-XXX-X-XXXXX-X--X-X--XXXXXXXX--XX-XX---X---XX-XX---X-XX-XXX--XXX-XX--X-XX-XXXX-XX--X-XXXXXXX-X-XXX-XXXX-
--XXX-XXXX---XXXX---XXX-XXX---X-X-XXX--XXXXXXXX-XXXXXXXX-XXX-X-XXXXX-XX-X-X--XXXXXXXX--XX-XX-X-X---XXXXX--XX-XX-XXX--XXX-XX--X-XX-XXXXXXX-XX-XXXXXXX-X-XXXXXXXX-
--XXX-XXXX--XXXXXX--XXX-XXX-X-XXX-XXX--XXXXXXXXXXXXXXXXX-XXXXX-XXXXX-XX-X-X--XXXXXXXX--XX-XX-X-XX-XXXXXX-XXX-XX-XXX--XXX-XXX-X-XX-XXXXXXX-XX-XXXXXXX-X-XXXXXXXX-
MXXXX-XXXX--XXXXXXXXXXX-XXX-X-XXXXXXXX-XXXXXXXXXXXXXXXXXXXXXXXXXXXXX-XXXX-X--XXXXXXXX-XXXXXX-X-XX-XXXXXX-XXX-XX-XXX-XXXXXXXX-X-XX-XXXXXXX-XX-XXXXXXXXXXXXXXXXXXF
XXXXXXXXXXX-XXXXXXXXXXX-XXX-X-XXXXXXXX-XXXXXXXXXXXXXXXXXXXXXXXXXXXXX-XXXX-XX-XXXXXXXXXXXXXXXXX-XX-XXXXXXXXXX-XXXXXXXXXXXXXXX-XXXXXXXXXXXX-XXXXXXXXXXXXXXXXXXXXXX
XXXXXXXXXXX-XXXXXXXXXXX-XXX-XXXXXXXXXXXXXXXXXXXXXXXXXXXXXXXXXXXXXXXXXXXXX-XX-XXXXXXXXXXXXXXXXXXXX-XXXXXXXXXXXXXXXXXXXXXXXXXX-XXXXXXXXXXXXXXXXXXXXXXXXXXXXXXXXXXX
