----------------------------------------------------------------------------------------------------------------------------------------------------------------
----------------------------X----------------X---------------X------------------------------------------X---X---X-------X-----------------X--------------X------
----------------------------X-X------X------XX-----X-----X---X-------------X---X-------------------X----X---X-X-X----X--X----------XX-----X----------X---X------
---X-------------X----------X-X------X------XX-----X-----X---X-------------X---X-X------X---X------X----X---X-X-X----X--X----------XX-X---X--X-------X---X------
---X-------X----XX---XXX---XX-X-----XX------XX-----X--X--X---X-------------X---X-X------X--XX------X----X---X-X-XX---X-XX----------XX-X---X--X-------X---X-X----
---XX-X----X----XX---XXX-X-XX-X---X-XX------XXX----X--XXXX---X-------------XX--X-X------X--XX------X----X---X-X-XX---X-XX--X-------XX-X---X--X----X--X---X-X----
---XXXX--X-X----XX---XXX-XXXX-XX--X-XX------XXX----X--XXXX---X-------------XX--X-X--X---X--XX------X----X---X-X-XX---X-XX-XX-------XXXX---X--X----X--X---X-X-X--
---XXXX--XXX----XX--XXXXXXXXX-XX--X-XX-X----XXX----X--XXXX---X-X------X----XX--X-X--XX--X--XX---X-XX----X---X-XXXX---X-XX-XX----X--XXXX---X--XXXX-X-XX---X-X-X--
---XXXX--XXXX---XX--XXXXXXXXX-XX-XX-XX-X----XXXX--XX--XXXX-X-X-X------X----XX--X-X--XX--X--XX--XX-XX----X---X-XXXX---X-XX-XX----X--XXXX---X--XXXX-X-XX---X-XXX--
---XXXX--XXXX---XX--XXXXXXXXX-XX-XXXXX-X--X-XXXX--XXX-XXXX-X-X-X-X--X-X----XX--X-X--XX--X--XX--XX-XX---XX-X-X-XXXXX--X-XXXXX-XX-X--XXXX---X--XXXX-X-XX---X-XXX--
---XXXX--XXXX---XX--XXXXXXXXX-XXXXXXXXXX--X-XXXXX-XXX-XXXX-X-X-X-XXXX-X----XXX-X-X-XXX--X--XX--XX-XX---XX-X-X-XXXXX--X-XXXXX-XX-X-XXXXX---X--XXXX-X-XX--XX-XXX--
--XXXXX-XXXXX---XXXXXXXXXXXXX-XXXXXXXXXX--X-XXXXX-XXX-XXXX-XXXXXXXXXX-X--X-XXX-X-X-XXX--X--XXX-XX-XX--XXX-XXX-XXXXX--X-XXXXX-XX-XXXXXXXX-XX--XXXX-X-XX--XX-XXX--
-XXXXXX-XXXXX---XXXXXXXXXXXXX-XXXXXXXXXX--X-XXXXX-XXX-XXXX-XXXXXXXXXX-XX-X-XXX-X-X-XXX--X--XXX-XXXXX-XXXX-XXX-XXXXXX-X-XXXXX-XX-XXXXXXXX-XXX-XXXX-X-XX--XX-XXXX-
MXXXXXX-XXXXXX-XXXXXXXXXXXXXX-XXXXXXXXXX--XXXXXXXXXXXXXXXX-XXXXXXXXXXXXX-XXXXXXX-X-XXXX-X-XXXX-XXXXX-XXXX-XXX-XXXXXX-X-XXXXX-XX-XXXXXXXX-XXX-XXXX-X-XX--XX-XXXXF
XXXXXXX-XXXXXX-XXXXXXXXXXXXXX-XXXXXXXXXX--XXXXXXXXXXXXXXXX-XXXXXXXXXXXXX-XXXXXXXXX-XXXX-XXXXXXXXXXXX-XXXX-XXX-XXXXXX-X-XXXXX-XX-XXXXXXXX-XXX-XXXX-X-XX--XXXXXXXX
XXXXXXXXXXXXXX-XXXXXXXXXXXXXXXXXXXXXXXXX--XXXXXXXXXXXXXXXXXXXXXXXXXXXXXX-XXXXXXXXX-XXXX-XXXXXXXXXXXXXXXXX-XXX-XXXXXX-XXXXXXXXXX-XXXXXXXX-XXX-XXXX-XXXXX-XXXXXXXX
