----------------------------------------------------------------------------------------------------------------------------------------------------------------
---------------------------X-----------X------------------------------X---------------X-----------XXX----X------------X-----------------------------------------
---------------------------X---X-------XXX----------------------------X----------X----X-----------XXX----X------X-----X---------------X--------X------X---------
-------X-------------------X---X---X---XXX--------------------X-X-X---X---X------X-X--X-----------XXX----X------X-----X---------------X--------X-X----X---------
------XX-------------------X-X-X---XX--XXX--X----------------XXXX-X---X---X------X-X--X-------X---XXX----XX-----X-X---X-------X-----X-X--------X-X----X-------X-
----X-XXX------X--X------X-X-X-X---XX--XXX--X---------X------XXXX-X---X---X----X-X-X--X--X----XX--XXX-X--XX-----X-X---X---X---X-----X-X--------X-X----X-------X-
----X-XXX------X--X------X-X-X-X--XXX--XXX--X--------XX------XXXX-X---X---X-X-XX-X-X--X--XX--XXX--XXX-X--XX-X---X-X---X---X---X-----X-X--------X-X----XXX-----X-
----X-XXX---X--X-XX----X-XXX-X-X--XXX-XXXX--X--------XX-----XXXXXXX--XX---X-X-XX-X-X--X--XX-XXXX--XXX-X-XXX-X--XX-X--XX---X---X-X--XX-XXXX-----X-X---XXXX-----X-
----X-XXX---X--X-XX----X-XXX-X-X--XXX-XXXX--X--------XXX----XXXXXXX--XX---X-X-XX-X-X--X--XX-XXXX-XXXX-X-XXX-X--XX-X--XX---X-X-X-X-XXX-XXXX-----X-X---XXXX-----X-
----X-XXX---X--X-XX-X-XX-XXX-X-X-XXXXXXXXX--XXX------XXX-X--XXXXXXX--XX---X-X-XX-X-X--X--XX-XXXX-XXXX-X-XXX-X--XX-X--XX---X-X-X-XXXXX-XXXX----XX-X---XXXXX----X-
----XXXXX---X-XX-XX-X-XX-XXXXXXX-XXXXXXXXX--XXX---X--XXX-XXXXXXXXXX--XX---X-X-XX-XXX--X--XX-XXXX-XXXX-X-XXX-XX-XX-X--XX---XXX-X-XXXXX-XXXXX---XXXX---XXXXX---XX-
----XXXXX---X-XX-XX-X-XX-XXXXXXX-XXXXXXXXX--XXX---X--XXX-XXXXXXXXXX-XXX---X-X-XX-XXX--X--XX-XXXX-XXXX-X-XXX-XX-XX-XX-XX---XXX-XXXXXXXXXXXXX-X-XXXX--XXXXXX-X-XX-
----XXXXX-X-X-XX-XX-X-XX-XXXXXXXXXXXXXXXXXX-XXX---X--XXX-XXXXXXXXXXXXXX-X-X-X-XXXXXX--X--XXXXXXX-XXXX-X-XXX-XXXXXXXXXXX---XXX-XXXXXXXXXXXXX-XXXXXX--XXXXXX-X-XX-
M---XXXXX-XXXXXX-XX-X-XXXXXXXXXXXXXXXXXXXXXXXXX---XX-XXX-XXXXXXXXXXXXXX-X-X-XXXXXXXX-XX--XXXXXXX-XXXXXX-XXXXXXXXXXXXXXX--XXXXXXXXXXXXXXXXXX-XXXXXXX-XXXXXX-XXXXF
X---XXXXX-XXXXXX-XX-X-XXXXXXXXXXXXXXXXXXXXXXXXX--XXX-XXX-XXXXXXXXXXXXXX-X-XXXXXXXXXXXXX--XXXXXXX-XXXXXXXXXXXXXXXXXXXXXX--XXXXXXXXXXXXXXXXXX-XXXXXXXXXXXXXX-XXXXX
X-XXXXXXXXXXXXXX-XX-X-XXXXXXXXXXXXXXXXXXXXXXXXX-XXXXXXXX-XXXXXXXXXXXXXX-X-XXXXXXXXXXXXXXXXXXXXXXXXXXXXXXXXXXXXXXXXXXXXX--XXXXXXXXXXXXXXXXXXXXXXXXXXXXXXXXXXXXXXX
