----------------------------------------------------------------------------------------------------------------------------------------------------------------
------------------X-----------X-----------------X-X---------------------------------------------X--------------X--------------X---------X-------------X-X-------
--X---------------X-----------X-----------------X-X---------------------X-X--X---------X-----X--X--X-X--------XX--------------X------X--X---X-X-------X-X-------
--X-------------X-X-----X---X-X-X---X--X----X--XX-X--X-------XX---------X-X--X---------X-----X--XX-X-X--------XX--------------X--X---X--X---X-X-------X-X-------
--X---------X---X-X-----X---XXX-X---X--X----X--XX-X--XX------XX---X----XX-X--X---------X----XX--XX-X-X-------XXX--------------X--X---X-XX---X-X-------X-X--X----
--X--X------X---X-X-----X--XXXX-X-X-X-XX----XX-XX-X--XX-----XXX---XX---XX-X--X---X--X-XX----XX--XX-X-X-------XXX--------------X-XX---XXXX---X-X-------X-XX-X-X--
--X--X------X---X-X-----X-XXXXX-XXX-XXXX----XX-XXXX--XX-----XXX---XX---XXXX-XX---X--X-XX----XX--XX-X-X---X-X-XXX-------X------X-XX---XXXX---X-X-------X-XX-X-X--
--X-XX------X--XX-X---X-X-XXXXX-XXX-XXXX----XX-XXXX--XX-----XXX---XX---XXXX-XX---X--X-XX----XX--XX-X-X---X-X-XXX-------X------X-XX--XXXXX-X-XXX-------X-XX-X-X--
--X-XX-----XXX-XX-X---X-XXXXXXX-XXX-XXXX----XX-XXXX--XX-----XXX---XX---XXXX-XX---X--XXXX----XXX-XX-X-X---X-X-XXXX------X------X-XX--XXXXX-X-XXX---X---X-XX-X-X--
--X-XX---X-XXX-XX-X---X-XXXXXXX-XXX-XXXX----XX-XXXX--XX----XXXX---XX---XXXXXXX-X-X--XXXX----XXX-XX-X-X---X-XXXXXX-----XX---X--X-XX--XXXXX-X-XXX---XX--X-XX-X-XX-
--X-XXX--X-XXX-XX-X---X-XXXXXXX-XXX-XXXX--X-XXXXXXX--XX----XXXX---XXX-XXXXXXXX-X-X--XXXX----XXX-XX-X-X---X-XXXXXX-----XX-X-X--X-XX--XXXXXXX-XXX---XX--X-XX-X-XX-
--X-XXX--XXXXX-XXXXX--X-XXXXXXX-XXX-XXXX--X-XXXXXXXX-XXXXXXXXXX---XXX-XXXXXXXXXXXX--XXXX-X--XXX-XX-X-X---X-XXXXXX-----XX-X-X--X-XX--XXXXXXX-XXX---XX--X-XX-XXXX-
--XXXXX--XXXXXXXXXXXX-X-XXXXXXX-XXX-XXXX-XX-XXXXXXXX-XXXXXXXXXX---XXX-XXXXXXXXXXXX-XXXXX-X--XXX-XXXX-X--XX-XXXXXX-X-XXXX-XXX--X-XX--XXXXXXX-XXX---XX--X-XX-XXXX-
M-XXXXXX-XXXXXXXXXXXX-X-XXXXXXX-XXX-XXXX-XXXXXXXXXXX-XXXXXXXXXX---XXX-XXXXXXXXXXXX-XXXXX-X--XXXXXXXX-X-XXX-XXXXXX-X-XXXX-XXX--X-XX--XXXXXXX-XXX---XX-XX-XX-XXXXF
XXXXXXXX-XXXXXXXXXXXX-XXXXXXXXX-XXXXXXXX-XXXXXXXXXXXXXXXXXXXXXX-X-XXXXXXXXXXXXXXXXXXXXXXXXX-XXXXXXXXXX-XXXXXXXXXX-X-XXXXXXXX-XX-XX-XXXXXXXX-XXXXX-XX-XX-XX-XXXXX
XXXXXXXXXXXXXXXXXXXXXXXXXXXXXXXXXXXXXXXXXXXXXXXXXXXXXXXXXXXXXXXXX-XXXXXXXXXXXXXXXXXXXXXXXXXXXXXXXXXXXXXXXXXXXXXXX-XXXXXXXXXXXXXXXX-XXXXXXXXXXXXXXXXXXXX-XX-XXXXX
