----------------------------------------------------------------------------------------------------------------------------------------------------------------
--------X------------------X--------------------------X--X---X----XX-----------X-------X------------X------X------------------------------------------X---------
--------X--------X--X------X-X-----------------X-X----X--X---XX---XX-----------X-------X----X--X---XX---X--X-----X-----------------------------------XX---------
----X---X--------X--X------X-X-----------------X-X----X--XX--XX-X-XX--X--------X-------X----X--XX--XX---X--X-----X----------X-----------X---X--------XX---------
----X---X---X----XX-X------X-X-X---------------X-X----X--XX--XX-XXXXX-X------X-X-------X----X--XX--XX---X--X-----X----------X--------X--X---X-----X--XX---------
----X-X-X---X----XX-X------X-X-X--------XX-----X-X----X--XX--XX-XXXXX-X------XXX-------X----X--XX--XX---X--X--X-XX--X-------X---X----X--X---X-----X--XX---------
----X-X-X---X---XXX-X------X-X-X--------XX-----XXX----XX-XXX-XX-XXXXX-XX--X--XXX-------X----X--XXX-XX---X--X--X-XX--X-------X-X-XX---XX-X---XX----X--XX-X-------
---XX-X-X---X---XXX-X----X-X-X-X--------XX--X--XXXX---XX-XXXXXX-XXXXX-XX--X--XXX-------X----X--XXX-XX---X--X--X-XX--X--X----X-X-XX---XX-X---XX----XX-XX-X---X---
---XX-XXX---X---XXX-X----X-X-XXX--------XX-XX--XXXX---XX-XXXXXX-XXXXX-XX--XX-XXX-------X----X--XXX-XX--XX--XX-X-XX--X--X---XX-X-XXX--XX-X---XX----XX-XX-X---X---
---XX-XXX---X---XXX-X----X-X-XXX--------XX-XX--XXXX---XX-XXXXXX-XXXXX-XX--XX-XXX----X--X----X--XXX-XX--XX--XX-X-XXX-X--X---XX-X-XXX--XX-X---XX----XX-XX-XXX-X---
---XX-XXX-XXX-X-XXX-X----X-XXXXX-XXX----XX-XX--XXXX---XX-XXXXXX-XXXXXXXX--XX-XXX----X--X----X--XXX-XX--XX--XX-XXXXX-X--X---XX-X-XXX--XX-X---XX----XXXXX-XXX-X---
---XX-XXX-XXX-X-XXX-XX---X-XXXXX-XXX----XXXXX--XXXX---XX-XXXXXX-XXXXXXXX--XX-XXX----X--X----X--XXX-XX--XXX-XXXXXXXX-X--X-X-XXXXXXXX--XX-X---XX----XXXXX-XXX-X---
---XXXXXX-XXXXX-XXX-XX-X-X-XXXXX-XXX----XXXXX-XXXXX---XX-XXXXXX-XXXXXXXX--XX-XXX----X--X----XXXXXX-XX--XXX-XXXXXXXX-X--X-X-XXXXXXXX--XXXX---XXX---XXXXX-XXX-XX--
M--XXXXXX-XXXXX-XXXXXX-X-X-XXXXX-XXX-X--XXXXX-XXXXX-XXXX-XXXXXX-XXXXXXXX--XX-XXXX---X--XX---XXXXXX-XX--XXXXXXXXXXXXXX--X-X-XXXXXXXX--XXXX-X-XXX--XXXXXXXXXX-XX-F
X--XXXXXXXXXXXXXXXXXXX-X-X-XXXXX-XXX-X--XXXXX-XXXXX-XXXX-XXXXXX-XXXXXXXX--XX-XXXX--XX-XXX---XXXXXX-XXXXXXXXXXXXXXXXXX--XXX-XXXXXXXX-XXXXXXX-XXX-XXXXXXXXXXX-XXXX
X--XXXXXXXXXXXXXXXXXXX-X-XXXXXXXXXXX-X-XXXXXXXXXXXXXXXXX-XXXXXX-XXXXXXXXX-XXXXXXX-XXXXXXXXXXXXXXXX-XXXXXXXXXXXXXXXXXXX-XXXXXXXXXXXX-XXXXXXXXXXXXXXXXXXXXXXX-XXXX
