- - - - - - - - - - - - - - - - - - - - - - - - - - - - - - - - - - - - - - - - - - - - - - - - - - - - - - - - - - - - - - - - - - - - - - - - - - - - - - - - - - - - - - - - - - - - - - - - - - - - - - - - - - - - - - - - - - - - - - - - - - - - - - - - 
- - - - - - - - - - - - - - - - - - - - - - - - - - - - - - - - - - - - - - - - - - - - - - - - - - - - - - - - - - - - - - - - - - - - - - - - - - - - - - - - - - - - - - - - - - - - - - - - - - - - - - - - - - - - - - - - - - - - - - - - - - - - - - - - 
- - - - - - - - - - - - - - - - - - - - - - - - - - - - - - - - - - - - - - - - - - - - - - - - - - - - - - - - - - - - - - - - - - - - - - - - - - - - - - - - - - - - - - - - - - - - - - - - - - - - - - - - - - - - - - - - - - - - - - - - - - - - - - - - 
- - - - - - - - - - - - - - - - - - - - - - - - - - - - - - - - - - - - - - - - - - - - - - - - - - - - - - - - - - - - - - - - - - - - - - - - - - - - - - - - - - - - - - - - - - - - - - - - - - - - - - - - - - - - - - - - - - - - - - - - - - - - - - - - 
- - - - - - - - - - - - - - - - - - - - - - - - - - - - - - - - - - - - - - - - - - - - - - - - - - - - - - - - - - - - - - - - - - - - - - - - - - - - - - - - - - - - - - - - - - - - - - - - - - - - - - - - - - - - - - - - - - - - - - - - - - - - - - - - 
- - - - - - - - - - - - - - - - - - - - - - - - - - - - - - - - - - - - - - - - - - - - - - - - - - - - - - - - - - - - - - - - - - - - - - - - - - - - - - - - - - - - - - - - - - - - - - - - - - - - - - - - - - - - - - - - - - - - - - - - - - - - - - - - 
- - - - - - - - - - - - - - - - - - - - - - - - - - - - - - - - - - - - - - - - - - - - - - - - - - - - - - - - - - - - - - - - - - - - - - - - X X - - - - - - - - - - - - - - - - - - - - - - - - - - - - - X X X X - - - - - - - - - - X X - - - - - - - - - 
- - - - - - - - - - - - - - - - - - - - - - - - - - - - - - - - - - - - - - - - - - - - - - - - - - - - - - - - - - - - - - - - - - - - - - - X X X - - - - - - - - - - - - - - - - - - - - - - - - - - - - - - - - - - - - - - - - - - X X X - - - - - - - - - 
- - - - - - - - - - - - - - - - - - - - - - - - - - - - - - - - - - - - - - - - - - - - - - - - - - - - - - - - - - - - - - - - - - - - - - X X X X - - - - - - - - - - - - - - - - - - - - - - - - - - - - - - - - - - - - - - - - - X X X X - - - - - - - - - 
- - - - - - - - - - - - - - - - - - - - - - - - - - - - - - - - - - - - - - - - - - - - - - - - - - - - - - - - - - - - - - - - - - - - - X X X X X - - - - - - - - - - - - - - - - - - - - - - - - - - - - - - - - - - - - - - - - X X X X X - - - - - - - - - 
- - - - - - - - - - - - - - - - - - - - - - - - - - - - - - - - - - - - - - - - - - - - - - - - - - - - - - - - - - - - - - - - - - - - X X X X X X - - - - - - - - - - - X X - - X - - - - - - - - - - - X X X X X X X X - - - - X X X X X X - - - - - - - - - 
- - - - - - - - - - - - - - - - - - - - - - - - - - - - - - - - - X - - - - - - - - - - - - - - - - - - - - - - - - - - - - - - - - - X X X X X X X - - - - - - - - - - X X X - - X X - - - - - - - - - - - - - - - - - - - - - X X X X X X X - - - - - - - - - 
- - - - - - - - - - - - - - - - - - - - - - - - - - - - - - - - X X - - - - - - - - - - - - - - - - - - - - - - - - - - - - - - - - X X X X X X X X - - - - - - - - - X X X X - - X X X - - - - - - - - - - - - - - - - - - - - X X X X X X X - - - - - - - - F  
M - - - - - - - - - - - - - - - - - - - - - - - - - - - - - - - X X - - - - - - - - - - - - - - - - - - - - - - - - - - - - - - - X X X X X X X X X - - - - - - - - X X X X X - - X X X X - - - - - - - - - - - - - - - - - - - X X X X X X X - - - - - - - - X 
X X X X X X X X X X X - - X X - X X X X X X X X - - X X - - X X X X - - - - - X X X X X X X X X X X X X X X X X X X X - - X X X X X X X X X X X X X X X X X X X X X X X X X X - - X X X X X X X X X X X X X X X - - X X X X X X X X X X X X X X X X X X X X X X 
X X X X X X X X X X X - - X X - X X X X X X X X - - X X - - X X X X - - - - - X X X X X X X X X X X X X X X X X X X X - - X X X X X X X X X X X X X X X X X X X X X X X X X X - - X X X X X X X X X X X X X X X - - X X X X X X X X X X X X X X X X X X X X X X 
