----------------------------------------------------------------------------------------------------------------------------------------------------------------
----------------------------------------------------------------------------------------------------------------------------------------------------------------
----------------------------------------------------------------------------------------------------------------------------------------------------------------
----------------------------------------------------------------------------------------------------------------------------------------------------------------
----------------------------------------------------------------------------------------------------------------------------------------------------------------
----------------------------------------------------------------------------------------------------------------------------------------------------------------
---X------------------------------------------------------------------------------------------------------------------------------------------------------------
---X------------------------------------------------------------------------------------------------------------------------------------------------------------
---X------------------------------------------------------------------------------------------------------------------------------------------------------------
---X------------------------------------------X-----------------------------------------------------------------------------------------------------------------
---X---X------XX-X-X-X--------------XX--------X-----X--XX-----------X----X-XX-X-X----XX------------X-----X------------X----X--------X-X-----X---------X---X---X-
-XXX-XXXXX-XX-XXXXXXXX---XXX-XXXXXXXXX-X-XXXXXXXXXXXXXXXXXXXXXX-XX-XXXXXXX-XXXXXXXXXXXXXX-XXXXXXXXXXXXXXXXXX-XXXX-X-XXXXXXXXX-XXXXXXXXXXX-XXXXXXXX-X--XXX-XXXXX-
-XXXXXXXXXXXXXXXXXXXXXXXXXXXXXXXXXXXXXXXXXXXXXXXXXXXXXXXXXXXXXXXXXXXXXXXXXXXXXXXXXXXXXXXXXXXXXXXXXXXXXXXXXXXXXXXXXXXXXXXXXXXXXXXXXXXXXXXXXXXXXXXXXXXXXXXXXXXXXX-
MXXXXXXXXXXXXXXXXXXXXXXXXXXXXXXXXXXXXXXXXXXXXXXXXXXXXXXXXXXXXXXXXXXXXXXXXXXXXXXXXXXXXXXXXXXXXXXXXXXXXXXXXXXXXXXXXXXXXXXXXXXXXXXXXXXXXXXXXXXXXXXXXXXXXXXXXXXXXXXF
XXXXXXXXXXXXXXXXXXXXXXXXXXXXXXXXXXXXXXXXXXXXXXXXXXXXXXXXXXXXXXXXXXXXXXXXXXXXXXXXXXXXXXXXXXXXXXXXXXXXXXXXXXXXXXXXXXXXXXXXXXXXXXXXXXXXXXXXXXXXXXXXXXXXXXXXXXXXXXXX
XXXXXXXXXXXXXXXXXXXXXXXXXXXXXXXXXXXXXXXXXXXXXXXXXXXXXXXXXXXXXXXXXXXXXXXXXXXXXXXXXXXXXXXXXXXXXXXXXXXXXXXXXXXXXXXXXXXXXXXXXXXXXXXXXXXXXXXXXXXXXXXXXXXXXXXXXXXXXXXX
