----------------------------------------------------------------------------------------------------------------------------------------------------------------
----------------------------------------------------------------------------------------------------------------------------------------------------------------
----------------------------------------------------------------------------------------------------------------------------------------------------------------
----------------------------------------------------------------------------------------------------------------------------------------------------------------
----------------------------------------------------------------------------------------------------------------------------------------------------------------
--X-------------------------------------------------------------------------------------------------------------------------------------------------------------
--X-------------------------------------------------------------------------------------------------------------------------------------------------------------
--X-------------------------------------------------------------------------------------------------------------------------------------------------------------
--X-------------------------------------------------------------------------------------------------------------------------------------------------------------
--X------------X------------------------------------------------------------------------------------------------------------------------------------------------
--X------------X-----X-------X-------------X---X-----------X--X----X--X----XX-----------------X----------------------X-X----X-----X-X------------XX---X--X-X----
-XXXXXX-XXXXX-XXXXXXXXXXXX-XXXXXXXXXXXXXXXXXXXXXX--X-X-XXXXXXXX-XXXXXXXXXXXXXXXXXXXXXXXX---XXXXXXXXXX-XX-X--XXXXXXX--XXXXXXXX-XXXXXXXXX-XXXXXXXXXXXXXXXX-X-X-XX-
-XXXXXX-XXXXXXXXXXXXXXXXXXXXXXXXXXXXXXXXXXXXXXXXXXXXXXXXXXXXXXXXXXXXXXXXXXXXXXXXXXXXXXXXXXXXXXXXXXXXXXXXXXXXXXXXXXXXXXXXXXXXXXXXXXXXXXXXXXXXXXXXXXXXXXXXXXXXXXX-
MXXXXXXXXXXXXXXXXXXXXXXXXXXXXXXXXXXXXXXXXXXXXXXXXXXXXXXXXXXXXXXXXXXXXXXXXXXXXXXXXXXXXXXXXXXXXXXXXXXXXXXXXXXXXXXXXXXXXXXXXXXXXXXXXXXXXXXXXXXXXXXXXXXXXXXXXXXXXXXF
XXXXXXXXXXXXXXXXXXXXXXXXXXXXXXXXXXXXXXXXXXXXXXXXXXXXXXXXXXXXXXXXXXXXXXXXXXXXXXXXXXXXXXXXXXXXXXXXXXXXXXXXXXXXXXXXXXXXXXXXXXXXXXXXXXXXXXXXXXXXXXXXXXXXXXXXXXXXXXXX
XXXXXXXXXXXXXXXXXXXXXXXXXXXXXXXXXXXXXXXXXXXXXXXXXXXXXXXXXXXXXXXXXXXXXXXXXXXXXXXXXXXXXXXXXXXXXXXXXXXXXXXXXXXXXXXXXXXXXXXXXXXXXXXXXXXXXXXXXXXXXXXXXXXXXXXXXXXXXXXX
