----------------------------------------------------------------------------------------------------------------------------------------------------------------
----------------------------------------------------------------------------------------------------------------------------------------------------------------
----------------------------------------------------------------------------------------------------------------------------------------------------------------
----------------------------------------------------------------------------------------------------------------------------------------------------------------
----------------------------------------------------------------------------------------------------------------------------------------------------------------
----X-----------------------------------------------------------------------------------------------------------------------------------------------------------
----X-----------------------------------------------------------------------------------------------------------------------------------------------------------
----X-----------------------------------------------------------------------------------------------------------------------------------------------------------
----X-----------------------------------------------------------------------------------------------------------------------------------------------------------
----X-----------------------------------------------------------------------------------------------------------------------------------------------------------
--X-X----X--------X-------X----X-X-------------X----XX----X-------X---XX-----XX---------X--------X----------X-----X--------XX--------------XX-X--X-------X------
-XXXXXXXXXX--X-X-XXX-XXXX-XXXX-XXXXXXXXXXXXXX-XXXXXXXXXXX-XXXXX-XXXX-XXXXX-XXXXX-XXXXXX-X-XXXX-XXXXXXXXXXXXXXXXXXXXX-XXX-XXXXXXXXXXX-XXX-XXXXXXXXXXXXXX--XXX--X-
-XXXXXXXXXX-XXXXXXXXXXXXXXXXXXXXXXXXXXXXXXXXXXXXXXXXXXXXXXXXXXXXXXXXXXXXXX-XXXXXXXXXXXXXXXXXXXXXXXXXXXXXXXXXXXXXXXXXXXXXXXXXXXXXXXXXXXXXXXXXXXXXXXXXXXX-XXXXXXX-
MXXXXXXXXXXXXXXXXXXXXXXXXXXXXXXXXXXXXXXXXXXXXXXXXXXXXXXXXXXXXXXXXXXXXXXXXXXXXXXXXXXXXXXXXXXXXXXXXXXXXXXXXXXXXXXXXXXXXXXXXXXXXXXXXXXXXXXXXXXXXXXXXXXXXXXXXXXXXXXF
XXXXXXXXXXXXXXXXXXXXXXXXXXXXXXXXXXXXXXXXXXXXXXXXXXXXXXXXXXXXXXXXXXXXXXXXXXXXXXXXXXXXXXXXXXXXXXXXXXXXXXXXXXXXXXXXXXXXXXXXXXXXXXXXXXXXXXXXXXXXXXXXXXXXXXXXXXXXXXXX
XXXXXXXXXXXXXXXXXXXXXXXXXXXXXXXXXXXXXXXXXXXXXXXXXXXXXXXXXXXXXXXXXXXXXXXXXXXXXXXXXXXXXXXXXXXXXXXXXXXXXXXXXXXXXXXXXXXXXXXXXXXXXXXXXXXXXXXXXXXXXXXXXXXXXXXXXXXXXXXX
