----------------------------------------------------------------------------------------------------------------------------------------------------------------
----------------------------------------------------------------------------------------------------------------------------------------------------------------
----------------------------------------------------------------------------------------------------------------------------------------------------------------
----------------------------------------------------------------------------------------------------------------------------------------------------------------
----------------------------------------------------------------------------------------------------------------------------------------------------------------
------------------------------X---------------------------------------------------------------------------------------------------------------------------------
------------------------------X---------------------------------------------------------------------------------------------------------------------------------
------------------------------X---------------------------------------------------------------------------------------------------------------------------------
------------------------------X---------------------------------------------------------------------------------------------------------------------------------
------------------------------X-----------------------------------X---------------------------------------------------------------------------------------------
------X------------XXX-------XX----XX-------------XX------X-------X-----------------X---X------X-------X----------------X-X-X--X---------X------X--------X----X-
-XX-X-XXXXXX-XXXXXXXXXXXXXXX-XXXX--XXXXXX-XXX-XX-XXXXXXX-XXX-XXXXXXXX-X-XXXXXXX-XXXXX--XX-XXX-XXXX-X-XXX-X-XXXX-X-XX-XXXX-XXX-XXX-XX-XXXXXX-XXXXXXXX-XX-XXX-XXX-
-XXXXXXXXXXXXXXXXXXXXXXXXXXXXXXXX-XXXXXXXXXXXXXXXXXXXXXXXXXXXXXXXXXXXXXXXXXXXXXXXXXXXX-XXXXXXXXXXXXXXXXXXXXXXXXXXXXXXXXXX-XXX-XXXXXX-XXXXXXXXXXXXXXX-XXXXXXXXXX-
MXXXXXXXXXXXXXXXXXXXXXXXXXXXXXXXXXXXXXXXXXXXXXXXXXXXXXXXXXXXXXXXXXXXXXXXXXXXXXXXXXXXXXXXXXXXXXXXXXXXXXXXXXXXXXXXXXXXXXXXXXXXXXXXXXXXXXXXXXXXXXXXXXXXXXXXXXXXXXXF
XXXXXXXXXXXXXXXXXXXXXXXXXXXXXXXXXXXXXXXXXXXXXXXXXXXXXXXXXXXXXXXXXXXXXXXXXXXXXXXXXXXXXXXXXXXXXXXXXXXXXXXXXXXXXXXXXXXXXXXXXXXXXXXXXXXXXXXXXXXXXXXXXXXXXXXXXXXXXXXX
XXXXXXXXXXXXXXXXXXXXXXXXXXXXXXXXXXXXXXXXXXXXXXXXXXXXXXXXXXXXXXXXXXXXXXXXXXXXXXXXXXXXXXXXXXXXXXXXXXXXXXXXXXXXXXXXXXXXXXXXXXXXXXXXXXXXXXXXXXXXXXXXXXXXXXXXXXXXXXXX
